date,state,positive,negative,death,dataQualityGrade,totalTestResults,new_negatives,new_positives,new_tests,ratio_new_positives
20200529,AK,430,49009,10,A,49439,1464,5,1469,0.003403676
20200529,AL,16823,192060,605,B,208883,7889,513,8402,0.061056891
20200529,AR,6538,113230,125,A,119768,866,0,866,0
20200529,AS,0,174,0,C,174,0,0,0,0
20200529,AZ,18465,191348,885,A+,209813,6197,702,6899,0.101753877
20200529,CA,103886,1731592,4068,B,1835478,42730,2189,44919,0.048732162
20200529,CO,25121,143838,1421,A,168959,5482,354,5836,0.060657985
20200529,CT,41762,199631,3868,B,241393,5665,203,5868,0.03459441
20200529,DC,8538,35320,460,A+,43858,298,46,344,0.13372093
20200529,DE,9236,48297,356,A,57533,667,65,732,0.088797814
20200529,FL,54497,928742,2495,A,983239,30411,1212,31623,0.038326534
20200529,GA,45670,404601,1974,A,450271,5025,600,5625,0.106666667
20200529,GU,172,5923,5,C,6095,133,0,133,0
20200529,HI,647,52177,17,D,52824,982,3,985,0.003045685
20200529,IA,18926,128394,522,A+,147320,4034,353,4387,0.08046501
20200529,ID,2769,41992,82,A,44761,848,38,886,0.042889391
20200529,IL,117455,734307,5270,A,851762,20174,1622,21796,0.074417324
20200529,IN,33558,215155,2110,A+,248713,5936,490,6426,0.076252723
20200529,KS,9719,85230,208,A,94949,10079,382,10461,0.036516585
20200529,KY,9184,212090,409,A,221274,39066,107,39173,0.002731473
20200529,LA,38802,316225,2766,B,355027,0,0,0,0
20200529,MA,95512,476233,6718,A,571745,8805,617,9422,0.065485035
20200529,MD,50988,233530,2466,B,284518,8381,1279,9660,0.132401656
20200529,ME,2226,43480,85,B,45706,0,37,37,1
20200529,MI,56621,464986,5406,A+,521607,16542,607,17149,0.03539565
20200529,MN,23531,210342,1006,A,233873,8081,584,8665,0.067397576
20200529,MO,12795,165055,738,B,177850,6661,122,6783,0.017986142
20200529,MP,22,5662,2,D,5684,261,0,261,0
20200529,MS,14790,151518,710,A,166308,9393,418,9811,0.042605239
20200529,MT,493,38036,17,C,38529,1728,8,1736,0.004608295
20200529,NC,26488,364743,859,A,391231,14963,1076,16039,0.067086477
20200529,ND,2520,66933,59,C,69453,1160,39,1199,0.032527106
20200529,NE,13261,81542,164,D,94803,1538,285,1823,0.15633571
20200529,NH,4386,62476,232,B,66862,1166,100,1266,0.078988942
20200529,NJ,158844,557567,11531,A+,716411,29525,1029,30554,0.033678078
20200529,NM,7364,176180,335,C,183544,3889,112,4001,0.027993002
20200529,NV,8350,126066,410,A+,134416,3084,142,3226,0.044017359
20200529,NY,368284,1575846,23780,A,1944130,65790,1551,67341,0.023032031
20200529,OH,34566,335324,2131,B,369890,9227,651,9878,0.065904029
20200529,OK,6338,181060,329,A+,187398,4924,68,4992,0.013621795
20200529,OR,4131,118550,151,A+,122681,2989,45,3034,0.014831905
20200529,PA,71339,366970,5464,A,438309,9166,1297,10463,0.123960623
20200529,PR,3647,0,132,B,3647,0,161,161,1
20200529,RI,14635,131720,693,A+,146355,5849,141,5990,0.023539232
20200529,SC,11131,177126,483,A,188257,5665,343,6008,0.057090546
20200529,SD,4866,35816,59,B,40682,1583,73,1656,0.044082126
20200529,TN,22085,399882,360,B,421967,5572,406,5978,0.067915691
20200529,TX,59776,833499,1626,B,893275,20057,0,20057,0
20200529,UT,9264,196591,107,B,205855,2005,343,2348,0.146081772
20200529,VA,42533,255844,1358,A+,298377,9964,1132,11096,0.102018745
20200529,VI,69,1633,6,C,1702,16,0,16,0
20200529,VT,975,30910,55,B,31885,732,1,733,0.001364256
20200529,WA,20764,322327,1106,B,343091,6932,358,7290,0.049108368
20200529,WI,17707,233588,568,A+,251295,12869,733,13602,0.053889134
20200529,WV,1951,91426,74,B,93377,3017,45,3062,0.014696277
20200529,WY,891,22378,15,C,23269,92,17,109,0.155963303
20200528,AK,425,47545,10,B,47970,1594,13,1607,0.008089608
20200528,AL,16310,184171,590,B,200481,4220,467,4687,0.099637295
20200528,AR,6538,112364,120,A,118902,3045,261,3306,0.078947368
20200528,AS,0,174,0,C,174,0,0,0,0
20200528,AZ,17763,185151,857,A+,202914,6147,501,6648,0.075361011
20200528,CA,101697,1688862,3973,B,1790559,50948,2717,53665,0.050628902
20200528,CO,24767,138356,1392,A,163123,3501,202,3703,0.054550365
20200528,CT,41559,193966,3826,B,235525,9907,256,10163,0.025189413
20200528,DC,8492,35022,453,A+,43514,731,86,817,0.105263158
20200528,DE,9171,47630,345,A,56801,1305,75,1380,0.054347826
20200528,FL,53285,898331,2446,A,951616,17394,651,18045,0.036076475
20200528,GA,45070,399576,1962,A,444646,3241,649,3890,0.166838046
20200528,GU,172,5790,5,C,5962,275,2,277,0.007220217
20200528,HI,644,51195,17,D,51839,636,1,637,0.001569859
20200528,IA,18573,124360,504,A+,142933,3194,213,3407,0.062518345
20200528,ID,2731,41144,82,A,43875,826,32,858,0.037296037
20200528,IL,115833,714133,5186,A,829966,24466,1527,25993,0.058746586
20200528,IN,33068,209219,2068,A+,242287,6323,631,6954,0.090739143
20200528,KS,9337,75151,205,A,84488,0,0,0,0
20200528,KY,9077,173024,400,A,182101,0,0,0,0
20200528,LA,38802,316225,2740,B,355027,7075,305,7380,0.041327913
20200528,MA,94895,467428,6640,A,562323,15640,1202,16842,0.071369196
20200528,MD,49709,225149,2428,B,274858,11517,1286,12803,0.100445208
20200528,ME,2189,43480,84,B,45669,0,52,52,1
20200528,MI,56014,448444,5372,A+,504458,9800,406,10206,0.039780521
20200528,MN,22947,202261,977,A,225208,8193,483,8676,0.055670816
20200528,MO,12673,158394,707,B,171067,5365,181,5546,0.032636134
20200528,MP,22,5401,2,D,5423,223,0,223,0
20200528,MS,14372,142125,693,A,156497,8037,328,8365,0.039210998
20200528,MT,485,36308,17,C,36793,1146,4,1150,0.003478261
20200528,NC,25412,349780,827,A,375192,10252,784,11036,0.071040232
20200528,ND,2481,65773,57,C,68254,872,42,914,0.04595186
20200528,NE,12976,80004,163,D,92980,2202,357,2559,0.13950762
20200528,NH,4286,61310,223,B,65596,1309,55,1364,0.040322581
20200528,NJ,157815,528042,11401,A+,685857,24345,1187,25532,0.046490678
20200528,NM,7252,172291,329,C,179543,-1225,122,-1103,-0.110607434
20200528,NV,8208,122982,406,A+,131190,2536,95,2631,0.036107944
20200528,NY,366733,1510056,23722,A,1876789,63477,1768,65245,0.027097862
20200528,OH,33915,326097,2098,B,360012,9811,476,10287,0.046271994
20200528,OK,6270,176136,326,A+,182406,3727,41,3768,0.010881104
20200528,OR,4086,115561,151,A+,119647,2607,48,2655,0.018079096
20200528,PA,70042,357804,5373,A,427846,7814,625,8439,0.074060908
20200528,PR,3486,0,131,B,3486,0,89,89,1
20200528,RI,14494,125871,677,A+,140365,1841,141,1982,0.071140262
20200528,SC,10788,171461,470,A,182249,6401,165,6566,0.025129455
20200528,SD,4793,34233,54,B,39026,937,83,1020,0.081372549
20200528,TN,21679,394310,356,B,415989,5986,373,6359,0.058657022
20200528,TX,59776,813442,1601,B,873218,15689,1855,17544,0.105734154
20200528,UT,8921,194586,106,B,203507,2666,215,2881,0.074626866
20200528,VA,41401,245880,1338,A+,287281,9082,1152,10234,0.112565957
20200528,VI,69,1617,6,C,1686,175,0,175,0
20200528,VT,974,30178,55,B,31152,150,3,153,0.019607843
20200528,WA,20406,315395,1095,B,335801,2785,225,3010,0.074750831
20200528,WI,16974,220719,550,A+,237693,10114,512,10626,0.0481837
20200528,WV,1906,88409,74,B,90315,1815,39,1854,0.021035599
20200528,WY,874,22286,15,C,23160,1634,24,1658,0.014475271
20200527,AK,412,45951,10,C,46363,1398,1,1399,0.000714796
20200527,AL,15843,179951,581,B,195794,1588,447,2035,0.21965602
20200527,AR,6277,109319,120,A,115596,3726,97,3823,0.025372744
20200527,AS,0,174,0,C,174,50,0,50,0
20200527,AZ,17262,179004,831,A+,196266,5056,479,5535,0.086540199
20200527,CA,98980,1637914,3884,B,1736894,38251,2247,40498,0.055484221
20200527,CO,24565,134855,1352,A,159420,3113,296,3409,0.086828982
20200527,CT,41303,184059,3769,B,225362,0,0,0,0
20200527,DC,8406,34291,445,A+,42697,570,72,642,0.112149533
20200527,DE,9096,46325,344,A,55421,477,30,507,0.059171598
20200527,FL,52634,880937,2400,A,933571,9968,379,10347,0.036628975
20200527,GA,44421,396335,1907,A,440756,-74880,691,-74189,-0.009314049
20200527,GU,170,5515,5,C,5685,0,1,1,1
20200527,HI,643,50559,17,D,51202,831,0,831,0
20200527,IA,18360,121166,491,A+,139526,3865,657,4522,0.145289695
20200527,ID,2699,40318,81,A,43017,1538,73,1611,0.04531347
20200527,IL,114306,689667,5083,A,803973,16068,1111,17179,0.064671983
20200527,IN,32437,202896,2030,A+,235333,4225,359,4584,0.078315881
20200527,KS,9337,75151,205,A,84488,2970,119,3089,0.038523794
20200527,KY,9077,173024,400,A,182101,11739,506,12245,0.041322989
20200527,LA,38497,309150,2722,B,347647,6178,443,6621,0.066908322
20200527,MA,93693,451788,6473,A,545481,0,0,0,0
20200527,MD,48423,213632,2392,B,262055,6832,736,7568,0.097251586
20200527,ME,2137,43480,81,B,45617,8030,28,8058,0.003474808
20200527,MI,55608,438644,5334,A+,494252,9469,504,9973,0.050536448
20200527,MN,22464,194068,942,A,216532,6130,504,6634,0.075972264
20200527,MO,12492,153029,696,B,165521,5022,201,5223,0.03848363
20200527,MP,22,5178,2,D,5200,260,0,260,0
20200527,MS,14044,134088,670,A,148132,0,313,313,1
20200527,MT,481,35162,17,C,35643,1807,2,1809,0.001105583
20200527,NC,24628,339528,794,A,364156,11337,488,11825,0.041268499
20200527,ND,2439,64901,56,C,67340,469,17,486,0.034979424
20200527,NE,12619,77802,153,D,90421,2115,264,2379,0.110970996
20200527,NH,4231,60001,214,B,64232,1159,34,1193,0.028499581
20200527,NJ,156628,503697,11339,A+,660325,23569,864,24433,0.03536201
20200527,NM,7130,173516,325,C,180646,3181,104,3285,0.031659056
20200527,NV,8113,120446,396,A+,128559,5076,116,5192,0.022342065
20200527,NY,364965,1446579,23643,A,1811544,36287,1129,37416,0.030174257
20200527,OH,33439,316286,2044,B,349725,9892,433,10325,0.041937046
20200527,OK,6229,172409,322,A+,178638,18605,92,18697,0.004920575
20200527,OR,4038,112954,148,A+,116992,1383,71,1454,0.048830812
20200527,PA,69417,349990,5265,A,419407,10155,780,10935,0.07133059
20200527,PR,3397,0,129,B,3397,0,73,73,1
20200527,RI,14353,124030,655,A+,138383,2877,143,3020,0.047350993
20200527,SC,10623,165060,466,A,175683,2742,207,2949,0.070193286
20200527,SD,4710,33296,54,B,38006,911,57,968,0.058884298
20200527,TN,21306,388324,353,B,409630,5785,341,6126,0.055664381
20200527,TX,57921,797753,1562,B,855674,33080,1361,34441,0.039516855
20200527,UT,8706,191920,105,B,200626,1948,86,2034,0.042281219
20200527,VA,40249,236798,1281,A+,277047,8959,907,9866,0.091931887
20200527,VI,69,1442,6,C,1511,17,0,17,0
20200527,VT,971,30028,54,B,30999,572,4,576,0.006944444
20200527,WA,20181,312610,1078,B,332791,2077,116,2193,0.052895577
20200527,WI,16462,210605,539,A+,227067,9731,599,10330,0.057986447
20200527,WV,1867,86594,74,B,88461,637,13,650,0.02
20200527,WY,850,20652,13,C,21502,0,0,0,0
20200526,AK,411,44553,10,C,44964,490,2,492,0.004065041
20200526,AL,15396,178363,575,B,193759,2778,666,3444,0.193379791
20200526,AR,6180,105593,119,A,111773,0,151,151,1
20200526,AS,0,124,0,C,124,0,0,0,0
20200526,AZ,16783,173948,807,A+,190731,2727,222,2949,0.075279756
20200526,CA,96733,1599663,3814,B,1696396,50119,2175,52294,0.04159177
20200526,CO,24269,131742,1333,A,156011,5608,95,5703,0.016657899
20200526,CT,41303,184059,3769,B,225362,3206,430,3636,0.118261826
20200526,DC,8334,33721,440,A+,42055,1143,109,1252,0.087060703
20200526,DE,9066,45848,335,B,54914,917,101,1018,0.099214145
20200526,FL,52255,870969,2338,A,923224,14480,509,14989,0.033958236
20200526,GA,43730,471215,1871,A,514945,1014,386,1400,0.275714286
20200526,GU,169,5515,5,C,5684,112,3,115,0.026086957
20200526,HI,643,49728,17,C,50371,0,0,0,0
20200526,IA,17703,117301,478,A+,135004,2163,126,2289,0.055045872
20200526,ID,2626,38780,79,A,41406,0,0,0,0
20200526,IL,113195,673599,4923,A,786794,16052,1178,17230,0.068369124
20200526,IN,32078,198671,2004,A+,230749,4135,363,4498,0.080702534
20200526,KS,9218,72181,188,A+,81399,0,0,0,0
20200526,KY,8571,161285,391,A,169856,0,0,0,0
20200526,LA,38054,302972,2701,B,341026,9883,245,10128,0.024190363
20200526,MA,93693,451788,6473,A,545481,4498,422,4920,0.085772358
20200526,MD,47687,206800,2333,B,254487,4375,535,4910,0.108961303
20200526,ME,2109,35450,79,B,37559,0,35,35,1
20200526,MI,55104,429175,5266,A+,484279,11196,223,11419,0.019528855
20200526,MN,21960,187938,908,A,209898,5194,645,5839,0.110464121
20200526,MO,12291,148007,686,B,160298,2789,124,2913,0.0425678
20200526,MP,22,4918,2,D,4940,183,0,183,0
20200526,MS,13731,134088,652,A,147819,3629,273,3902,0.069964121
20200526,MT,479,33355,17,C,33834,152,0,152,0
20200526,NC,24140,328191,766,A,352331,7465,176,7641,0.023033634
20200526,ND,2422,64432,54,C,66854,539,-35,504,-0.069444444
20200526,NE,12355,75687,150,D,88042,2089,221,2310,0.095670996
20200526,NH,4197,58842,210,B,63039,1605,48,1653,0.029038113
20200526,NJ,155764,480128,11191,A+,635892,11423,672,12095,0.055560149
20200526,NM,7026,170335,320,C,177361,3797,83,3880,0.021391753
20200526,NV,7997,115370,396,A+,123367,8518,118,8636,0.013663733
20200526,NY,363836,1410292,23564,A,1774128,33607,1072,34679,0.030912079
20200526,OH,33006,306394,2002,B,339400,8537,529,9066,0.058349879
20200526,OK,6137,153804,318,A+,159941,-1139,47,-1092,-0.043040293
20200526,OR,3967,111571,148,A+,115538,1662,18,1680,0.010714286
20200526,PA,68637,339835,5152,A,408472,4907,451,5358,0.084173199
20200526,PR,3324,0,129,B,3324,0,64,64,1
20200526,RI,14210,121153,634,A+,135363,2517,145,2662,0.054470323
20200526,SC,10416,162318,446,A+,172734,6476,238,6714,0.035448317
20200526,SD,4653,32385,50,C,37038,1688,67,1755,0.038176638
20200526,TN,20965,382539,343,B,403504,6927,358,7285,0.049142073
20200526,TX,56560,764673,1536,B,821233,14990,589,15579,0.037807305
20200526,UT,8620,189972,101,B,198592,2025,99,2124,0.046610169
20200526,VA,39342,227839,1236,A+,267181,6816,1615,8431,0.191554976
20200526,VI,69,1425,6,C,1494,82,0,82,0
20200526,VT,967,29456,54,B,30423,749,5,754,0.0066313
20200526,WA,20065,310533,1070,B,330598,3768,237,4005,0.05917603
20200526,WI,15863,200874,517,A+,216737,7495,279,7774,0.03588886
20200526,WV,1854,85957,74,B,87811,1406,80,1486,0.053835801
20200526,WY,850,20652,13,C,21502,1101,12,1113,0.010781671
20200525,AK,409,44063,10,C,44472,964,1,965,0.001036269
20200525,AL,14730,175585,562,B,190315,4113,403,4516,0.089238264
20200525,AR,6029,105593,117,A,111622,2934,107,3041,0.035185794
20200525,AS,0,124,0,C,124,0,0,0,0
20200525,AZ,16561,171221,806,A+,187782,3919,222,4141,0.053610239
20200525,CA,94558,1549544,3795,B,1644102,59509,1848,61357,0.030118813
20200525,CO,24174,126134,1332,A,150308,47,210,257,0.817120623
20200525,CT,40873,180853,3742,B,221726,7185,405,7590,0.053359684
20200525,DC,8225,32578,440,A+,40803,-11447,259,-11188,-0.023149803
20200525,DE,8965,44931,332,B,53896,1870,156,2026,0.076999013
20200525,FL,51746,856489,2331,A,908235,36121,879,37000,0.023756757
20200525,GA,43344,470201,1830,A,513545,31085,506,31591,0.01601722
20200525,GU,166,5403,5,C,5569,0,0,0,0
20200525,HI,643,49728,17,C,50371,799,0,799,0
20200525,IA,17577,115138,459,A+,132715,4634,325,4959,0.065537407
20200525,ID,2626,38780,79,A,41406,0,0,0,0
20200525,IL,112017,657547,4884,A,769564,19930,1713,21643,0.079147992
20200525,IN,31715,194536,1976,A+,226251,5111,339,5450,0.062201835
20200525,KS,9218,72181,188,A+,81399,4705,260,4965,0.052366566
20200525,KY,8571,161285,391,A,169856,0,0,0,0
20200525,LA,37809,293089,2690,B,330898,14222,640,14862,0.043062845
20200525,MA,93271,447290,6416,A,540561,7592,596,8188,0.072789448
20200525,MD,47152,202425,2302,B,249577,8376,839,9215,0.091047206
20200525,ME,2074,35450,78,B,37524,0,19,19,1
20200525,MI,54881,417979,5240,A+,472860,21426,202,21628,0.009339745
20200525,MN,21315,182744,890,A,204059,5353,742,6095,0.12173913
20200525,MO,12167,145218,685,B,157385,5587,179,5766,0.031044051
20200525,MP,22,4735,2,D,4757,0,0,0,0
20200525,MS,13458,130459,635,A,143917,5809,206,6015,0.034247714
20200525,MT,479,33203,16,C,33682,301,0,301,0
20200525,NC,23964,320726,754,A,344690,7292,742,8034,0.092357481
20200525,ND,2457,63893,54,C,66350,823,39,862,0.045243619
20200525,NE,12134,73598,150,D,85732,2382,145,2527,0.057380293
20200525,NH,4149,57237,209,B,61386,1787,60,1847,0.032485111
20200525,NJ,155092,468705,11144,A+,623797,19052,938,19990,0.046923462
20200525,NM,6943,166538,317,C,173481,4214,148,4362,0.03392939
20200525,NV,7879,106852,394,A+,114731,4341,109,4450,0.024494382
20200525,NY,362764,1376685,23488,A,1739449,38374,1249,39623,0.031522096
20200525,OH,32477,297857,1987,B,330334,5215,566,5781,0.097906937
20200525,OK,6090,154943,313,A+,161033,0,53,53,1
20200525,OR,3949,109909,148,A+,113858,1641,22,1663,0.013229104
20200525,PA,68186,334928,5139,A,403114,6546,473,7019,0.067388517
20200525,PR,3260,0,129,B,3260,0,71,71,1
20200525,RI,14065,118636,608,A+,132701,0,0,0,0
20200525,SC,10178,155842,440,A+,166020,1991,82,2073,0.039556199
20200525,SD,4586,30697,50,C,35283,355,23,378,0.060846561
20200525,TN,20607,375612,338,B,396219,12181,462,12643,0.03654196
20200525,TX,55971,749683,1527,B,805654,41486,623,42109,0.014794937
20200525,UT,8521,187947,98,B,196468,1906,129,2035,0.063390663
20200525,VA,37727,221023,1208,A+,258750,13182,1483,14665,0.101125128
20200525,VI,69,1343,6,C,1412,0,0,0,0
20200525,VT,962,28707,54,B,29669,1073,6,1079,0.005560704
20200525,WA,19828,306765,1061,B,326593,10074,243,10317,0.023553359
20200525,WI,15584,193379,514,A+,208963,7173,307,7480,0.041042781
20200525,WV,1774,84551,72,B,86325,616,15,631,0.023771791
20200525,WY,838,19551,12,C,20389,330,25,355,0.070422535
20200524,AK,408,43099,10,C,43507,1156,0,1156,0
20200524,AL,14327,171472,551,B,185799,2734,389,3123,0.124559718
20200524,AR,5922,102659,116,A,108581,5224,310,5534,0.056017347
20200524,AS,0,124,0,C,124,0,0,0,0
20200524,AZ,16339,167302,800,A+,183641,2902,300,3202,0.093691443
20200524,CA,92710,1490035,3774,B,1582745,65360,2079,67439,0.030827859
20200524,CO,23964,126087,1327,A,150051,4622,477,5099,0.093547754
20200524,CT,40468,173668,3693,B,214136,5323,446,5769,0.077309759
20200524,DC,7966,44025,427,A+,51991,0,0,0,0
20200524,DE,8809,43061,326,B,51870,1217,119,1336,0.089071856
20200524,FL,50867,820368,2316,A,871235,14058,740,14798,0.050006758
20200524,GA,42838,439116,1824,A,481954,27711,706,28417,0.024844283
20200524,GU,166,5403,5,C,5569,209,1,210,0.004761905
20200524,HI,643,48929,17,C,49572,750,1,751,0.001331558
20200524,IA,17252,110504,454,A+,127756,3456,359,3815,0.094102228
20200524,ID,2626,38780,79,A,41406,766,31,797,0.038895859
20200524,IL,110304,637617,4856,A,747921,23166,2508,25674,0.097686375
20200524,IN,31376,189425,1976,A+,220801,5393,475,5868,0.080947512
20200524,KS,8958,67476,185,A+,76434,0,0,0,0
20200524,KY,8571,161285,391,A,169856,-1748,145,-1603,-0.090455396
20200524,LA,37169,278867,2690,B,316036,1460,129,1589,0.081183134
20200524,MA,92675,439698,6372,A,532373,10374,1013,11387,0.088961096
20200524,MD,46313,194049,2277,B,240362,7217,818,8035,0.101804605
20200524,ME,2055,35450,78,B,37505,0,42,42,1
20200524,MI,54679,396553,5228,A+,451232,0,314,314,1
20200524,MN,20573,177391,878,A,197964,7743,728,8471,0.085940267
20200524,MO,11988,139631,681,B,151619,3079,236,3315,0.071191554
20200524,MP,22,4735,2,D,4757,439,0,439,0
20200524,MS,13252,124650,625,A,137902,3435,247,3682,0.067083107
20200524,MT,479,32902,16,C,33381,729,0,729,0
20200524,NC,23222,313434,744,A,336656,6577,497,7074,0.07025728
20200524,ND,2418,63070,53,C,65488,1287,53,1340,0.039552239
20200524,NE,11989,71216,147,D,83205,2896,327,3223,0.101458269
20200524,NH,4089,55450,208,B,59539,0,0,0,0
20200524,NJ,154154,449653,11133,A+,603807,24022,1050,25072,0.041879387
20200524,NM,6795,162324,308,C,169119,10566,170,10736,0.015834575
20200524,NV,7770,102511,392,A+,110281,3160,74,3234,0.02288188
20200524,NY,361515,1338311,23391,A,1699826,46176,1589,47765,0.033267037
20200524,OH,31911,292642,1969,B,324553,7556,503,8059,0.062414692
20200524,OK,6037,154943,311,A+,160980,0,77,77,1
20200524,OR,3927,108268,148,A+,112195,1949,39,1988,0.019617706
20200524,PA,67713,328382,5124,A,396095,6913,730,7643,0.095512233
20200524,PR,3189,0,127,B,3189,0,89,89,1
20200524,RI,14065,118636,608,A+,132701,2456,113,2569,0.043985987
20200524,SC,10096,153851,435,A+,163947,4836,201,5037,0.039904705
20200524,SD,4563,30342,50,C,34905,1282,95,1377,0.068990559
20200524,TN,20145,363431,336,B,383576,9462,356,9818,0.036259931
20200524,TX,55348,708197,1506,B,763545,0,839,839,1
20200524,UT,8392,186041,97,B,194433,3522,132,3654,0.036124795
20200524,VA,36244,207841,1171,A+,244085,11120,495,11615,0.042617305
20200524,VI,69,1343,6,C,1412,0,0,0,0
20200524,VT,956,27634,54,B,28590,1164,2,1166,0.001715266
20200524,WA,19585,296691,1055,B,316276,7598,320,7918,0.040414246
20200524,WI,15277,186206,510,A+,201483,6877,400,7277,0.054967706
20200524,WV,1759,83935,72,B,85694,1908,42,1950,0.021538462
20200524,WY,813,19221,12,C,20034,0,0,0,0
20200523,AK,408,41943,10,C,42351,901,4,905,0.00441989
20200523,AL,13938,168738,546,B,182676,4533,375,4908,0.076405868
20200523,AR,5612,97435,113,A,103047,0,0,0,0
20200523,AS,0,124,0,C,124,0,0,0,0
20200523,AZ,16039,164400,799,A+,180439,4005,431,4436,0.097159603
20200523,CA,90631,1424675,3708,B,1515306,46346,2187,48533,0.045062123
20200523,CO,23487,121465,1324,A,144952,2431,296,2727,0.108544188
20200523,CT,40022,168345,3675,B,208367,5657,382,6039,0.063255506
20200523,DC,7966,44025,427,A+,51991,8925,73,8998,0.008112914
20200523,DE,8690,41844,324,B,50534,1387,161,1548,0.104005168
20200523,FL,50127,806310,2312,A,856437,20265,676,20941,0.032281171
20200523,GA,42132,411405,1811,A,453537,25374,914,26288,0.034768716
20200523,GU,165,5194,5,C,5359,80,0,80,0
20200523,HI,642,48179,17,C,48821,841,-5,836,-0.005980861
20200523,IA,16893,107048,444,A+,123941,3302,389,3691,0.105391493
20200523,ID,2595,38014,79,A,40609,953,61,1014,0.060157791
20200523,IL,107796,614451,4790,A,722247,22762,2352,25114,0.093652943
20200523,IN,30901,184032,1943,A+,214933,5880,492,6372,0.077212806
20200523,KS,8958,67476,185,A+,76434,0,0,0,0
20200523,KY,8426,163033,391,A,171459,5079,140,5219,0.026825062
20200523,LA,37040,277407,2668,B,314447,2524,115,2639,0.043577113
20200523,MA,91662,429324,6304,A,520986,8569,773,9342,0.082744594
20200523,MD,45495,186832,2243,B,232327,3354,1071,4425,0.242033898
20200523,ME,2013,35450,77,B,37463,0,65,65,1
20200523,MI,54365,396553,5223,A+,450918,-21318,452,-20866,-0.021662034
20200523,MN,19845,169648,861,A,189493,7682,840,8522,0.098568411
20200523,MO,11752,136552,676,B,148304,-24836,194,-24642,-0.007872738
20200523,MP,22,4296,2,D,4318,0,0,0,0
20200523,MS,13005,121215,616,A,134220,-4134,381,-3753,-0.101518785
20200523,MT,479,32173,16,C,32652,795,0,795,0
20200523,NC,22725,306857,737,A,329582,25251,1107,26358,0.041998634
20200523,ND,2365,61783,52,C,64148,1270,48,1318,0.036418816
20200523,NE,11662,68320,147,D,79982,1326,237,1563,0.151631478
20200523,NH,4089,55450,208,B,59539,4285,154,4439,0.034692498
20200523,NJ,153104,425631,11081,A+,578735,23036,385,23421,0.016438239
20200523,NM,6625,151758,302,C,158383,5463,153,5616,0.02724359
20200523,NV,7696,99351,388,A+,107047,6811,295,7106,0.041514213
20200523,NY,359926,1292135,23282,A,1652061,49496,1772,51268,0.03456347
20200523,OH,31408,285086,1956,B,316494,8080,614,8694,0.070623418
20200523,OK,5960,154943,311,A+,160903,7625,111,7736,0.014348501
20200523,OR,3888,106319,147,A+,110207,2344,24,2368,0.010135135
20200523,PA,66983,321469,5096,A,388452,8726,725,9451,0.076711459
20200523,PR,3100,0,127,B,3100,0,70,70,1
20200523,RI,13952,116180,597,A+,130132,2777,216,2993,0.072168393
20200523,SC,9895,149015,425,A+,158910,8630,257,8887,0.028918645
20200523,SD,4468,29060,50,C,33528,1072,112,1184,0.094594595
20200523,TN,19789,353969,329,B,373758,12347,395,12742,0.030999843
20200523,TX,54509,708197,1506,B,762706,20284,1060,21344,0.049662669
20200523,UT,8260,182519,97,B,190779,3742,203,3945,0.051457541
20200523,VA,35749,196721,1159,A+,232470,6496,799,7295,0.109527073
20200523,VI,69,1343,6,C,1412,0,0,0,0
20200523,VT,954,26470,54,B,27424,1689,2,1691,0.001182732
20200523,WA,19265,289093,1050,B,308358,5283,148,5431,0.027250967
20200523,WI,14877,179329,507,A+,194206,6626,481,7107,0.067679752
20200523,WV,1717,82027,72,B,83744,-1186,101,-1085,-0.093087558
20200523,WY,813,19221,12,C,20034,600,10,610,0.016393443
20200522,AK,404,41042,10,C,41446,1899,2,1901,0.001052078
20200522,AL,13563,164205,537,B,177768,6585,444,7029,0.06316688
20200522,AR,5612,97435,113,A,103047,3617,154,3771,0.040837974
20200522,AS,0,124,0,C,124,0,0,0,0
20200522,AZ,15608,160395,775,A+,176003,4083,293,4376,0.066956124
20200522,CA,88444,1378329,3630,B,1466773,43399,2247,45646,0.049226657
20200522,CO,23191,119034,1310,A,142225,6220,394,6614,0.059570608
20200522,CT,39640,162688,3637,B,202328,5449,432,5881,0.073456895
20200522,DC,7893,35100,418,A+,42993,1132,105,1237,0.084882781
20200522,DE,8529,40457,322,B,48986,1301,143,1444,0.099030471
20200522,FL,49451,786045,2268,A,835496,20791,776,21567,0.035980897
20200522,GA,41218,386031,1785,A,427249,18705,813,19518,0.041653858
20200522,GU,165,5114,5,C,5279,215,0,215,0
20200522,HI,647,47338,17,C,47985,832,4,836,0.004784689
20200522,IA,16504,103746,425,A+,120250,3351,334,3685,0.09063772
20200522,ID,2534,37061,77,A,39595,679,28,707,0.03960396
20200522,IL,105444,591689,4715,A,697133,22355,2758,25113,0.109823597
20200522,IN,30409,178152,1941,A+,208561,5093,473,5566,0.084980237
20200522,KS,8958,67476,185,A+,76434,4812,419,5231,0.080099407
20200522,KY,8286,157954,386,A,166240,7449,119,7568,0.015724101
20200522,LA,36925,274883,2668,B,311808,6006,421,6427,0.065504901
20200522,MA,90889,420755,6228,A,511644,9353,805,10158,0.079247883
20200522,MD,44424,183478,2207,B,227902,6776,893,7669,0.116442822
20200522,ME,1948,35450,75,B,37398,0,71,71,1
20200522,MI,53913,417871,5158,A+,471784,16641,403,17044,0.023644684
20200522,MN,19005,161966,851,A,180971,6610,805,7415,0.108563722
20200522,MO,11558,161388,671,B,172946,10636,218,10854,0.020084761
20200522,MP,22,4296,2,D,4318,229,0,229,0
20200522,MS,12624,125349,596,A,137973,11601,402,12003,0.033491627
20200522,MT,479,31378,16,C,31857,1333,0,1333,0
20200522,NC,21618,281606,728,A,303224,11821,758,12579,0.060259162
20200522,ND,2317,60513,52,C,62830,1463,88,1551,0.056737589
20200522,NE,11425,66994,143,D,78419,2476,303,2779,0.109032026
20200522,NH,3935,51165,199,B,55100,2203,67,2270,0.029515419
20200522,NJ,152719,402595,10985,A+,555314,9793,1247,11040,0.112952899
20200522,NM,6472,146295,294,C,152767,5268,155,5423,0.028581966
20200522,NV,7401,92540,381,A+,99941,5413,146,5559,0.026263716
20200522,NY,358154,1242639,23195,A,1600793,44042,1696,45738,0.037080764
20200522,OH,30794,277006,1872,B,307800,8095,627,8722,0.071887182
20200522,OK,5849,147318,307,A+,153167,3403,169,3572,0.04731243
20200522,OR,3864,103975,147,A+,107839,2568,47,2615,0.017973231
20200522,PA,66258,312743,4984,A,379001,9229,866,10095,0.085785042
20200522,PR,3030,0,126,B,3030,0,117,117,1
20200522,RI,13736,113403,579,A+,127139,3607,165,3772,0.043743372
20200522,SC,9638,140385,419,A+,150023,11322,463,11785,0.03928723
20200522,SD,4356,27988,50,C,32344,937,106,1043,0.101629914
20200522,TN,19394,341622,315,B,361016,0,433,433,1
20200522,TX,53449,687913,1480,B,741362,0,1181,1181,1
20200522,UT,8057,178777,93,B,186834,3777,183,3960,0.046212121
20200522,VA,34950,190225,1136,A+,225175,5763,813,6576,0.123631387
20200522,VI,69,1343,6,C,1412,29,0,29,0
20200522,VT,952,24781,54,B,25733,30,2,32,0.0625
20200522,WA,19117,283810,1044,B,302927,48,21,69,0.304347826
20200522,WI,14396,172703,496,A+,187099,9465,511,9976,0.051222935
20200522,WV,1616,83213,71,B,84829,1665,23,1688,0.013625592
20200522,WY,803,18621,12,C,19424,568,16,584,0.02739726
20200521,AK,402,39143,10,C,39545,2500,0,2500,0
20200521,AL,13119,157620,529,B,170739,5914,375,6289,0.059627922
20200521,AR,5458,93818,110,A,99276,2563,455,3018,0.150762094
20200521,AS,0,124,0,D,124,0,0,0,0
20200521,AZ,15315,156312,763,A+,171627,5774,418,6192,0.06750646
20200521,CA,86197,1334930,3542,B,1421127,38867,2140,41007,0.052186212
20200521,CO,22797,112814,1299,A,135611,3459,315,3774,0.083465819
20200521,CT,39208,157239,3582,B,196447,5538,191,5729,0.033339152
20200521,DC,7788,33968,412,A,41756,1100,237,1337,0.177262528
20200521,DE,8386,39156,317,B,47542,1938,192,2130,0.090140845
20200521,FL,48675,765254,2222,A,813929,41377,1204,42581,0.028275522
20200521,GA,40405,367326,1754,A,407731,4033,758,4791,0.158213317
20200521,GU,165,4899,5,C,5064,92,0,92,0
20200521,HI,643,46506,17,C,47149,843,2,845,0.002366864
20200521,IA,16170,100395,406,A+,116565,5261,556,5817,0.095581915
20200521,ID,2506,36382,77,B,38888,291,30,321,0.093457944
20200521,IL,102686,569334,4607,A,672020,27039,2268,29307,0.077387655
20200521,IN,29936,173059,1913,A+,202995,6595,662,7257,0.091222268
20200521,KS,8539,62664,178,A+,71203,0,0,0,0
20200521,KY,8167,150505,376,A,158672,4588,98,4686,0.020913359
20200521,LA,36504,268877,2629,B,305381,18223,1188,19411,0.061202411
20200521,MA,90084,411402,6148,A,501486,10419,1114,11533,0.096592387
20200521,MD,43531,176702,2159,B,220233,3695,1208,4903,0.246379767
20200521,ME,1877,35450,73,B,37327,0,58,58,1
20200521,MI,53510,401230,5129,A+,454740,17167,501,17668,0.02835635
20200521,MN,18200,155356,818,A,173556,5688,530,6218,0.08523641
20200521,MO,11340,150752,661,B,162092,0,108,108,1
20200521,MP,22,4067,2,D,4089,271,1,272,0.003676471
20200521,MS,12222,113748,580,A,125970,5035,255,5290,0.048204159
20200521,MT,479,30045,16,C,30524,797,1,798,0.001253133
20200521,NC,20860,269785,716,A,290645,12304,738,13042,0.056586413
20200521,ND,2229,59050,51,C,61279,1945,134,2079,0.064454064
20200521,NE,11122,64518,138,D,75640,3229,276,3505,0.07874465
20200521,NH,3868,48962,190,B,52830,1795,147,1942,0.07569516
20200521,NJ,151472,392802,10843,A+,544274,11858,1073,12931,0.082978888
20200521,NM,6317,141027,283,C,147344,4973,125,5098,0.024519419
20200521,NV,7255,87127,378,A+,94382,3122,89,3211,0.027717222
20200521,NY,356458,1198597,23083,A,1555055,47131,2088,49219,0.042422642
20200521,OH,30167,268911,1836,B,299078,8819,731,9550,0.076544503
20200521,OK,5680,143915,304,A+,149595,5076,148,5224,0.028330781
20200521,OR,3817,101407,145,A+,105224,3059,16,3075,0.005203252
20200521,PA,65392,303514,4869,B,368906,17480,1726,19206,0.08986775
20200521,PR,2913,0,126,C,2913,0,47,47,1
20200521,RI,13571,109796,556,A+,123367,2624,215,2839,0.075730891
20200521,SC,9175,129063,407,A+,138238,3056,119,3175,0.037480315
20200521,SD,4250,27051,48,C,31301,839,73,912,0.08004386
20200521,TN,18961,341622,313,B,360583,6141,429,6570,0.065296804
20200521,TX,52268,687913,1440,B,740181,18308,945,19253,0.04908326
20200521,UT,7874,175000,92,B,182874,3046,164,3210,0.051090343
20200521,VA,34137,184462,1099,A+,218599,4744,1229,5973,0.20575925
20200521,VI,69,1314,6,C,1383,0,0,0,0
20200521,VT,950,24751,54,B,25701,637,6,643,0.00933126
20200521,WA,19096,283762,1037,B,302858,0,0,0,0
20200521,WI,13885,163238,487,A+,177123,8938,472,9410,0.050159405
20200521,WV,1593,81548,70,B,83141,2452,48,2500,0.0192
20200521,WY,787,18053,11,C,18840,0,0,0,0
20200520,AK,402,36643,10,C,37045,662,3,665,0.004511278
20200520,AL,12744,151706,517,B,164450,6516,368,6884,0.053457292
20200520,AR,5003,91255,107,A,96258,2477,80,2557,0.031286664
20200520,AS,0,124,0,D,124,0,0,0,0
20200520,AZ,14897,150538,747,A+,165435,3533,331,3864,0.085662526
20200520,CA,84057,1296063,3436,B,1380120,38542,2262,40804,0.055435742
20200520,CO,22482,109355,1257,A,131837,224,280,504,0.555555556
20200520,CT,39017,151701,3529,B,190718,4611,587,5198,0.112928049
20200520,DC,7551,32868,407,A,40419,928,117,1045,0.111961722
20200520,DE,8194,37218,310,B,45412,1123,157,1280,0.12265625
20200520,FL,47471,723877,2173,A+,771348,54966,527,55493,0.009496693
20200520,GA,39647,363293,1687,A,402940,23858,926,24784,0.037362815
20200520,GU,165,4807,5,C,4972,134,11,145,0.075862069
20200520,HI,641,45663,17,C,46304,1280,1,1281,0.00078064
20200520,IA,15614,95134,388,A+,110748,2835,265,3100,0.085483871
20200520,ID,2476,36091,77,B,38567,477,21,498,0.042168675
20200520,IL,100418,542295,4525,A,642713,18641,2388,21029,0.113557468
20200520,IN,29274,166464,1864,A+,195738,5839,569,6408,0.088795256
20200520,KS,8539,62664,178,A+,71203,4014,199,4213,0.04723475
20200520,KY,8069,145917,366,A,153986,0,0,0,0
20200520,LA,35316,250654,2608,B,285970,7619,278,7897,0.035203242
20200520,MA,88970,400983,6066,A,489953,11968,1045,13013,0.080304311
20200520,MD,42323,173007,2123,B,215330,5895,777,6672,0.116456835
20200520,ME,1819,35450,73,B,37269,13358,78,13436,0.005805299
20200520,MI,53009,384063,5060,A+,437072,13509,659,14168,0.046513269
20200520,MN,17670,149668,786,A,167338,4862,641,5503,0.116481919
20200520,MO,11232,150752,631,B,161984,7722,152,7874,0.019304039
20200520,MP,21,3796,2,D,3817,0,0,0,0
20200520,MS,11967,108713,570,A,120680,2657,263,2920,0.090068493
20200520,MT,478,29248,16,C,29726,769,7,776,0.009020619
20200520,NC,20122,257481,702,A,277603,12173,422,12595,0.033505359
20200520,ND,2095,57105,49,C,59200,1368,101,1469,0.068754255
20200520,NE,10846,61289,132,D,72135,1930,221,2151,0.10274291
20200520,NH,3721,47167,182,B,50888,1345,69,1414,0.048797737
20200520,NJ,150399,380944,10747,A+,531343,9775,1386,11161,0.124182421
20200520,NM,6192,136054,276,C,142246,4530,96,4626,0.02075227
20200520,NV,7166,84005,373,A,91171,3496,120,3616,0.033185841
20200520,NY,354370,1151466,22976,A,1505836,36572,1525,38097,0.040029399
20200520,OH,29436,260092,1781,B,289528,11442,484,11926,0.040583599
20200520,OK,5532,138839,299,A+,144371,5181,43,5224,0.00823124
20200520,OR,3801,98348,144,A+,102149,2354,75,2429,0.030876904
20200520,PA,63666,286034,4624,B,349700,0,0,0,0
20200520,PR,2866,0,125,C,2866,0,61,61,1
20200520,RI,13356,107172,538,A+,120528,2877,405,3282,0.123400366
20200520,SC,9056,126007,399,A+,135063,0,0,0,0
20200520,SD,4177,26212,46,C,30389,588,92,680,0.135294118
20200520,TN,18532,335481,309,B,354013,7736,154,7890,0.019518378
20200520,TX,51323,669605,1419,B,720928,19371,1411,20782,0.067895294
20200520,UT,7710,171954,90,B,179664,5316,326,5642,0.057780929
20200520,VA,32908,179718,1074,A+,212626,9074,763,9837,0.077564298
20200520,VI,69,1314,6,C,1383,16,0,16,0
20200520,VT,944,24114,54,B,25058,0,0,0,0
20200520,WA,19096,283762,1031,B,302858,563,11,574,0.019163763
20200520,WI,13413,154300,481,A+,167713,6063,528,6591,0.08010924
20200520,WV,1545,79096,69,B,80641,2304,36,2340,0.015384615
20200520,WY,787,18053,11,C,18840,969,21,990,0.021212121
20200519,AK,399,35981,10,B,36380,769,0,769,0
20200519,AL,12376,145190,504,B,157566,153,290,443,0.65462754
20200519,AR,4923,88778,102,A,93701,8352,110,8462,0.012999291
20200519,AS,0,124,0,C,124,19,0,19,0
20200519,AZ,14566,147005,704,A+,161571,4702,396,5098,0.077677521
20200519,CA,81795,1257521,3334,B,1339316,45279,1365,46644,0.029264214
20200519,CO,22202,109131,1224,A,131333,2574,264,2838,0.093023256
20200519,CT,38430,147090,3472,B,185520,7527,314,7841,0.040045913
20200519,DC,7434,31940,400,A,39374,1385,164,1549,0.105874758
20200519,DE,8037,36095,304,B,44132,1506,168,1674,0.100358423
20200519,FL,46944,668911,2129,A+,715855,38941,502,39443,0.012727227
20200519,GA,38721,339435,1664,A+,378156,13227,640,13867,0.046152737
20200519,GU,154,4673,5,C,4827,104,0,104,0
20200519,HI,640,44383,17,B,45023,2978,0,2978,0
20200519,IA,15349,92299,372,A+,107648,4106,394,4500,0.087555556
20200519,ID,2455,35614,74,B,38069,1361,36,1397,0.025769506
20200519,IL,98030,523654,4379,A,621684,16898,1545,18443,0.083771621
20200519,IN,28705,160625,1824,A+,189330,4968,450,5418,0.083056478
20200519,KS,8340,58650,173,A,66990,0,0,0,0
20200519,KY,8069,145917,366,A+,153986,23920,381,24301,0.015678367
20200519,LA,35038,243035,2581,B,278073,7996,329,8325,0.03951952
20200519,MA,87925,389015,5938,A+,476940,14199,1915,16114,0.11884076
20200519,MD,41546,167112,2081,B,208658,5368,1784,7152,0.249440716
20200519,ME,1741,22092,73,B,23833,0,28,28,1
20200519,MI,52350,370554,5017,A+,422904,12291,435,12726,0.03418199
20200519,MN,17029,144806,757,A+,161835,4572,657,5229,0.125645439
20200519,MO,11080,143030,616,B,154110,2637,135,2772,0.048701299
20200519,MP,21,3796,2,D,3817,397,0,397,0
20200519,MS,11704,106056,554,A,117760,1721,272,1993,0.136477672
20200519,MT,471,28479,16,B,28950,782,1,783,0.001277139
20200519,NC,19700,245308,691,A,265008,8576,677,9253,0.07316546
20200519,ND,1994,55737,45,C,57731,1107,63,1170,0.053846154
20200519,NE,10625,59359,125,C,69984,2206,277,2483,0.111558598
20200519,NH,3652,45822,172,B,49474,4540,56,4596,0.012184508
20200519,NJ,149013,371169,10586,A+,520182,13639,974,14613,0.06665298
20200519,NM,6096,131524,270,C,137620,4209,158,4367,0.036180444
20200519,NV,7046,80509,365,B,87555,5583,140,5723,0.024462694
20200519,NY,352845,1114894,22843,A,1467739,26708,1474,28182,0.052302888
20200519,OH,28952,248650,1720,B,277602,5255,498,5753,0.086563532
20200519,OK,5489,133658,294,A+,139147,15496,91,15587,0.005838198
20200519,OR,3726,95994,140,A+,99720,2366,39,2405,0.016216216
20200519,PA,63666,286034,4624,B,349700,8481,610,9091,0.067099329
20200519,PR,2805,0,124,C,2805,0,95,95,1
20200519,RI,12951,104295,532,A+,117246,1706,156,1862,0.083780881
20200519,SC,9056,126007,399,A,135063,3390,114,3504,0.032534247
20200519,SD,4085,25624,46,B,29709,606,58,664,0.087349398
20200519,TN,18378,327745,305,A,346123,8328,367,8695,0.042208166
20200519,TX,49912,650234,1369,A,700146,19082,1219,20301,0.060046303
20200519,UT,7384,166638,80,B,174022,0,0,0,0
20200519,VA,32145,170644,1041,A+,202789,5558,1005,6563,0.15313119
20200519,VI,69,1298,6,C,1367,20,0,20,0
20200519,VT,944,24114,54,B,25058,567,0,567,0
20200519,WA,19085,283199,1002,A,302284,2960,66,3026,0.021810972
20200519,WI,12885,148237,467,A+,161122,3735,198,3933,0.050343249
20200519,WV,1509,76792,68,B,78301,2248,18,2266,0.007943513
20200519,WY,766,17084,10,B,17850,753,12,765,0.015686275
20200518,AK,399,35212,10,B,35611,957,3,960,0.003125
20200518,AL,12086,145037,489,B,157123,458,315,773,0.407503234
20200518,AR,4813,80426,100,A,85239,0,54,54,1
20200518,AS,0,105,0,C,105,0,0,0,0
20200518,AZ,14170,142303,686,A+,156473,4479,233,4712,0.049448217
20200518,CA,80430,1212242,3302,B,1292672,55838,1591,57429,0.027703773
20200518,CO,21938,106557,1215,A,128495,2642,305,2947,0.10349508
20200518,CT,38116,139563,3449,B,177679,6375,697,7072,0.098557692
20200518,DC,7270,30555,392,A,37825,1152,147,1299,0.113163972
20200518,DE,7869,34589,297,B,42458,1394,199,1593,0.124921532
20200518,FL,46442,629970,2073,A+,676412,23766,854,24620,0.034687246
20200518,GA,38081,326208,1642,A+,364289,12734,380,13114,0.028976666
20200518,GU,154,4569,5,C,4723,119,0,119,0
20200518,HI,640,41405,17,B,42045,370,1,371,0.002695418
20200518,IA,14955,88193,355,A+,103148,2603,304,2907,0.104575163
20200518,ID,2419,34253,73,B,36672,0,0,0,0
20200518,IL,96485,506756,4234,A,603241,19003,2294,21297,0.107714702
20200518,IN,28255,155657,1765,A+,183912,6192,477,6669,0.071524966
20200518,KS,8340,58650,173,A,66990,4944,454,5398,0.084105224
20200518,KY,7688,121997,334,A+,129685,0,0,0,0
20200518,LA,34709,235039,2563,B,269748,4301,277,4578,0.060506772
20200518,MA,86010,374816,5797,A+,460826,0,0,0,0
20200518,MD,39762,161744,2023,B,201506,5622,958,6580,0.145592705
20200518,ME,1713,22092,71,B,23805,0,26,26,1
20200518,MI,51915,358263,4915,A+,410178,12447,773,13220,0.058472012
20200518,MN,16372,140234,740,A+,156606,5317,704,6021,0.116924099
20200518,MO,10945,140393,605,B,151338,4927,156,5083,0.030690537
20200518,MP,21,3399,2,D,3420,81,0,81,0
20200518,MS,11432,104335,528,A,115767,2505,136,2641,0.051495646
20200518,MT,470,27697,16,B,28167,1280,2,1282,0.001560062
20200518,NC,19023,236732,661,A,255755,6300,511,6811,0.075025694
20200518,ND,1931,54630,44,C,56561,1309,31,1340,0.023134328
20200518,NE,10348,57153,123,C,67501,1733,128,1861,0.068780226
20200518,NH,3596,41282,172,B,44878,86,40,126,0.317460317
20200518,NJ,148039,357530,10435,A+,505569,16299,1705,18004,0.094701178
20200518,NM,5938,127315,265,C,133253,4588,81,4669,0.017348469
20200518,NV,6906,74926,350,B,81832,1146,49,1195,0.041004184
20200518,NY,351371,1088186,22729,A,1439557,24911,1250,26161,0.047781048
20200518,OH,28454,243395,1657,B,271849,6856,531,7387,0.071883038
20200518,OK,5398,118162,288,A+,123560,0,88,88,1
20200518,OR,3687,93628,138,A+,97315,2895,64,2959,0.021628929
20200518,PA,63056,277553,4505,C,340609,6883,822,7705,0.106683971
20200518,PR,2710,0,124,C,2710,0,64,64,1
20200518,RI,12795,102589,506,A+,115384,2713,121,2834,0.042695836
20200518,SC,8942,122617,391,A,131559,10947,126,11073,0.01137903
20200518,SD,4027,25018,44,B,29045,446,40,486,0.082304527
20200518,TN,18011,319417,301,A,337428,11525,623,12148,0.051284162
20200518,TX,48693,631152,1347,A,679845,28581,909,29490,0.030824008
20200518,UT,7384,166638,80,B,174022,3124,146,3270,0.044648318
20200518,VA,31140,165086,1014,A+,196226,5113,752,5865,0.128218244
20200518,VI,69,1278,6,C,1347,0,0,0,0
20200518,VT,944,23547,54,B,24491,573,4,577,0.006932409
20200518,WA,19019,280239,1001,A,299258,4957,114,5071,0.022480773
20200518,WI,12687,144502,459,A+,157189,4828,144,4972,0.028962188
20200518,WV,1491,74544,67,B,76035,544,1,545,0.001834862
20200518,WY,754,16331,8,B,17085,0,0,0,0
20200517,AK,396,34255,10,B,34651,1366,4,1370,0.002919708
20200517,AL,11771,144579,488,B,156350,2608,248,2856,0.086834734
20200517,AR,4759,80426,98,A,85185,3360,181,3541,0.051115504
20200517,AS,0,105,0,C,105,0,0,0,0
20200517,AZ,13937,137824,680,A+,151761,4667,306,4973,0.061532274
20200517,CA,78839,1156404,3261,B,1235243,54071,2046,56117,0.03645954
20200517,CO,21633,103915,1192,A,125548,3307,401,3708,0.108144552
20200517,CT,37419,133188,3408,B,170607,5136,716,5852,0.122351333
20200517,DC,7123,29403,383,A,36526,913,81,994,0.081488934
20200517,DE,7670,33195,290,B,40865,984,123,1107,0.111111111
20200517,FL,45588,606204,2049,A+,651792,20968,777,21745,0.035732352
20200517,GA,37701,313474,1606,A+,351175,29552,554,30106,0.018401648
20200517,GU,154,4450,5,C,4604,85,0,85,0
20200517,HI,639,41035,17,B,41674,790,1,791,0.001264223
20200517,IA,14651,85590,351,A+,100241,3618,323,3941,0.081958894
20200517,ID,2419,34253,73,B,36672,954,30,984,0.030487805
20200517,IL,94191,487753,4177,A,581944,18561,1734,20295,0.085439763
20200517,IN,27778,149465,1751,A+,177243,5387,498,5885,0.08462192
20200517,KS,7886,53706,172,A,61592,0,0,0,0
20200517,KY,7688,121997,334,A+,129685,1707,244,1951,0.12506407
20200517,LA,34432,230738,2491,B,265170,5113,315,5428,0.058032424
20200517,MA,86010,374816,5797,A+,460826,11660,1077,12737,0.084556803
20200517,MD,38804,156122,1992,B,194926,3915,836,4751,0.175962955
20200517,ME,1687,22092,70,B,23779,0,39,39,1
20200517,MI,51142,345816,4891,A+,396958,38399,638,39037,0.016343469
20200517,MN,15668,134917,731,A+,150585,6605,699,7304,0.095700986
20200517,MO,10789,135466,594,B,146255,6801,114,6915,0.0164859
20200517,MP,21,3318,2,D,3339,0,0,0,0
20200517,MS,11296,101830,521,A,113126,4477,173,4650,0.037204301
20200517,MT,468,26417,16,B,26885,794,0,794,0
20200517,NC,18512,230432,659,A,248944,9828,530,10358,0.051168179
20200517,ND,1900,53321,43,C,55221,1682,52,1734,0.029988466
20200517,NE,10220,55420,123,C,65640,5214,448,5662,0.079123984
20200517,NH,3556,41196,171,B,44752,1984,92,2076,0.044315992
20200517,NJ,146334,341231,10356,A+,487565,11096,1245,12341,0.100883235
20200517,NM,5857,122727,259,C,128584,3931,195,4126,0.04726127
20200517,NV,6857,73780,349,B,80637,6778,195,6973,0.027965008
20200517,NY,350121,1063275,22619,A,1413396,32790,1889,34679,0.054471006
20200517,OH,27923,236539,1625,B,264462,17311,449,17760,0.025281532
20200517,OK,5310,118162,288,A+,123472,0,73,73,1
20200517,OR,3623,90733,137,A+,94356,2146,11,2157,0.005099675
20200517,PA,62234,270670,4418,C,332904,4445,623,5068,0.122928177
20200517,PR,2646,0,123,C,2646,0,57,57,1
20200517,RI,12674,99876,499,A+,112550,3830,240,4070,0.058968059
20200517,SC,8816,111670,380,A,120486,10461,409,10870,0.037626495
20200517,SD,3987,24572,44,B,28559,355,28,383,0.07310705
20200517,TN,17388,307892,298,A,325280,4979,100,5079,0.019688915
20200517,TX,47784,602571,1336,A,650355,10831,785,11616,0.067579201
20200517,UT,7238,163514,80,B,170752,3808,170,3978,0.042735043
20200517,VA,30388,159973,1009,A+,190361,4088,705,4793,0.147089506
20200517,VI,69,1278,6,C,1347,84,0,84,0
20200517,VT,940,22974,54,B,23914,777,0,777,0
20200517,WA,18905,275282,1000,A,294187,1629,52,1681,0.030933968
20200517,WI,12543,139674,453,A+,152217,5468,356,5824,0.061126374
20200517,WV,1490,74000,67,B,75490,2064,33,2097,0.015736767
20200517,WY,754,16331,8,B,17085,653,38,691,0.054992764
20200516,AK,392,32889,10,B,33281,859,4,863,0.004634994
20200516,AL,11523,141971,485,B,153494,7124,307,7431,0.041313417
20200516,AR,4578,77066,98,A,81644,0,115,115,1
20200516,AS,0,105,0,C,105,0,0,0,0
20200516,AZ,13631,133157,679,A+,146788,4325,462,4787,0.096511385
20200516,CA,76793,1102333,3204,B,1179126,43363,1857,45220,0.0410659
20200516,CO,21232,100608,1150,A,121840,3416,394,3810,0.103412073
20200516,CT,36703,128052,3339,B,164755,8229,618,8847,0.069854188
20200516,DC,7042,28490,375,A,35532,1022,171,1193,0.143336127
20200516,DE,7547,32211,286,B,39758,1306,174,1480,0.117567568
20200516,FL,44811,585236,2040,A+,630047,19609,1601,21210,0.075483263
20200516,GA,37147,283922,1592,A+,321069,18729,466,19195,0.024277156
20200516,GU,154,4365,5,C,4519,4,0,4,0
20200516,HI,638,40245,17,B,40883,2106,1,2107,0.000474608
20200516,IA,14328,81972,346,A+,96300,2455,279,2734,0.102048281
20200516,ID,2389,33299,73,B,35688,905,38,943,0.040296925
20200516,IL,92457,469192,4129,A,561649,20959,2088,23047,0.090597475
20200516,IN,27280,144078,1741,A+,171358,5285,625,5910,0.105752961
20200516,KS,7886,53706,172,A,61592,0,0,0,0
20200516,KY,7444,120290,332,A+,127734,6237,219,6456,0.033921933
20200516,LA,34117,225625,2479,B,259742,6273,280,6553,0.042728521
20200516,MA,84933,363156,5705,A+,448089,10898,1512,12410,0.121837228
20200516,MD,37968,152207,1957,B,190175,6367,982,7349,0.133623622
20200516,ME,1648,22092,70,B,23740,0,45,45,1
20200516,MI,50504,307417,4880,A+,357921,0,425,425,1
20200516,MN,14969,128312,709,A+,143281,7883,729,8612,0.084649327
20200516,MO,10675,128665,589,B,139340,4663,219,4882,0.044858664
20200516,MP,21,3318,2,D,3339,12,2,14,0.142857143
20200516,MS,11123,97353,510,A,108476,1331,322,1653,0.194797338
20200516,MT,468,25623,16,B,26091,671,2,673,0.002971768
20200516,NC,17982,220604,652,A,238586,6186,853,7039,0.121181986
20200516,ND,1848,51639,42,C,53487,1685,87,1772,0.049097065
20200516,NE,9772,50206,119,C,59978,2407,356,2763,0.128845458
20200516,NH,3464,39212,159,B,42676,64,0,64,0
20200516,NJ,145089,330135,10249,A+,475224,11068,1184,12252,0.096637284
20200516,NM,5662,118796,253,C,124458,4698,159,4857,0.032736257
20200516,NV,6662,67002,345,B,73664,1470,48,1518,0.031620553
20200516,NY,348232,1030485,22478,A,1378717,38250,2419,40669,0.059480194
20200516,OH,27474,219228,1610,B,246702,0,520,520,1
20200516,OK,5237,118162,288,A+,123399,5056,151,5207,0.028999424
20200516,OR,3612,88587,137,A+,92199,2622,71,2693,0.026364649
20200516,PA,61611,266225,4403,C,327836,7015,989,8004,0.123563218
20200516,PR,2589,0,122,B,2589,0,47,47,1
20200516,RI,12434,96046,489,A+,108480,3287,215,3502,0.061393489
20200516,SC,8407,101209,380,A,109616,0,0,0,0
20200516,SD,3959,24217,44,B,28176,690,72,762,0.094488189
20200516,TN,17288,302913,295,A,320201,10127,318,10445,0.030445189
20200516,TX,46999,591740,1305,A,638739,27308,1801,29109,0.061870899
20200516,UT,7068,159706,78,B,166774,3401,155,3556,0.043588301
20200516,VA,29683,155885,1002,A+,185568,6543,1011,7554,0.133836378
20200516,VI,69,1194,6,C,1263,0,0,0,0
20200516,VT,940,22197,53,B,23137,960,8,968,0.008264463
20200516,WA,18853,273653,992,A,292506,2675,112,2787,0.040186581
20200516,WI,12187,134206,453,A+,146393,5549,502,6051,0.082961494
20200516,WV,1457,71936,64,B,73393,2441,16,2457,0.006512007
20200516,WY,716,15678,7,B,16394,371,1,372,0.002688172
20200515,AK,388,32030,10,B,32418,655,1,656,0.00152439
20200515,AL,11216,134847,476,B,146063,3830,248,4078,0.060814125
20200515,AR,4463,77066,98,A,81529,5484,227,5711,0.039747855
20200515,AS,0,105,0,C,105,0,0,0,0
20200515,AZ,13169,128832,651,A+,142001,7168,495,7663,0.064596111
20200515,CA,74936,1058970,3108,B,1133906,27483,1772,29255,0.060570843
20200515,CO,20838,97192,1091,A,118030,3148,363,3511,0.103389348
20200515,CT,36085,119823,3285,B,155908,5725,621,6346,0.097856918
20200515,DC,6871,27468,368,A,34339,1205,135,1340,0.100746269
20200515,DE,7373,30905,271,B,38278,1271,150,1421,0.105559465
20200515,FL,43210,565627,1991,A+,608837,0,0,0,0
20200515,GA,36681,265193,1557,A+,301874,15170,823,15993,0.051460014
20200515,GU,154,4361,5,C,4515,135,1,136,0.007352941
20200515,HI,637,38139,17,B,38776,-104,-1,-105,0.00952381
20200515,IA,14049,79517,336,A+,93566,3898,374,4272,0.087546816
20200515,ID,2351,32394,72,B,34745,964,27,991,0.027245207
20200515,IL,90369,448233,4058,A,538602,24133,2432,26565,0.091549031
20200515,IN,26655,138793,1691,A+,165448,4607,602,5209,0.115569207
20200515,KS,7886,53706,172,A,61592,3546,418,3964,0.105449041
20200515,KY,7225,114053,328,A+,121278,3738,145,3883,0.037342261
20200515,LA,33837,219352,2448,B,253189,5253,348,5601,0.062131762
20200515,MA,83421,352258,5592,A+,435679,10079,1239,11318,0.109471638
20200515,MD,36986,145840,1911,B,182826,3289,1083,4372,0.247712717
20200515,ME,1603,22092,69,B,23695,0,38,38,1
20200515,MI,50079,307417,4825,A+,357496,21116,497,21613,0.022995419
20200515,MN,14240,120429,692,A+,134669,5112,805,5917,0.136048673
20200515,MO,10456,124002,576,B,134458,7209,139,7348,0.018916712
20200515,MP,19,3306,2,D,3325,0,0,0,0
20200515,MS,10801,96022,493,A,106823,1179,318,1497,0.21242485
20200515,MT,466,24952,16,B,25418,865,4,869,0.004602992
20200515,NC,17129,214418,641,A,231547,11657,622,12279,0.050655591
20200515,ND,1761,49954,42,C,51715,1355,114,1469,0.077603812
20200515,NE,9416,47799,113,C,57215,3533,341,3874,0.088022716
20200515,NH,3464,39148,159,B,42612,3272,165,3437,0.048006983
20200515,NJ,143905,319067,10138,A+,462972,10075,1201,11276,0.1065094
20200515,NM,5503,114098,242,C,119601,4451,139,4590,0.030283224
20200515,NV,6614,65532,339,B,72146,2547,115,2662,0.043200601
20200515,NY,345813,992235,22304,A,1338048,36529,2762,39291,0.070295997
20200515,OH,26954,219228,1581,B,246182,12233,597,12830,0.046531567
20200515,OK,5086,113106,285,A+,118192,5885,124,6009,0.020635713
20200515,OR,3541,85965,137,A+,89506,5394,62,5456,0.011363636
20200515,PA,60622,259210,4342,C,319832,7651,986,8637,0.114160009
20200515,PR,2542,0,122,B,2542,0,115,115,1
20200515,RI,12219,92759,479,A+,104978,3174,203,3377,0.060112526
20200515,SC,8407,101209,380,A,109616,6863,218,7081,0.030786612
20200515,SD,3887,23527,44,B,27414,846,95,941,0.100956429
20200515,TN,16970,292786,290,A,309756,7168,271,7439,0.036429628
20200515,TX,45198,564432,1272,A,609630,20970,1347,22317,0.060357575
20200515,UT,6913,156305,77,B,163218,2935,164,3099,0.052920297
20200515,VA,28672,149342,977,A+,178014,10325,859,11184,0.076806152
20200515,VI,69,1194,6,C,1263,30,0,30,0
20200515,VT,932,21237,53,B,22169,740,1,741,0.001349528
20200515,WA,18741,270978,983,A,289719,5816,245,6061,0.040422373
20200515,WI,11685,128657,445,A+,140342,6059,410,6469,0.063379193
20200515,WV,1441,69495,62,B,70936,2209,14,2223,0.006297796
20200515,WY,715,15307,7,B,16022,578,14,592,0.023648649
20200514,AK,387,31375,10,B,31762,1109,4,1113,0.00359389
20200514,AL,10968,131017,467,B,141985,5262,351,5613,0.062533405
20200514,AR,4236,71582,97,A,75818,2531,72,2603,0.027660392
20200514,AS,0,105,0,C,105,0,0,0,0
20200514,AZ,12674,121664,624,A+,134338,6090,498,6588,0.075591985
20200514,CA,73164,1031487,3032,B,1104651,37036,2023,39059,0.051793441
20200514,CO,20475,94044,1062,A,114519,2951,318,3269,0.097277455
20200514,CT,35464,114098,3219,B,149562,6010,609,6619,0.092007856
20200514,DC,6736,26263,358,A,32999,1189,152,1341,0.113348248
20200514,DE,7223,29634,260,B,36857,1833,271,2104,0.128802281
20200514,FL,43210,565627,1948,A+,608837,13266,808,14074,0.057410828
20200514,GA,35858,250023,1527,A+,285881,11451,526,11977,0.043917509
20200514,GU,153,4226,5,C,4379,116,1,117,0.008547009
20200514,HI,638,38243,17,B,38881,513,3,516,0.005813953
20200514,IA,13675,75619,318,A+,89294,3189,386,3575,0.107972028
20200514,ID,2324,31430,69,B,33754,595,31,626,0.049520767
20200514,IL,87937,424100,3928,A,512037,19439,3239,22678,0.142825646
20200514,IN,26053,134186,1646,A+,160239,5576,580,6156,0.094217024
20200514,KS,7468,50160,164,A,57628,0,0,0,0
20200514,KY,7080,110315,326,A+,117395,6534,227,6761,0.033574915
20200514,LA,33489,214099,2417,B,247588,8857,827,9684,0.085398596
20200514,MA,82182,342179,5482,A+,424361,12644,1685,14329,0.117593691
20200514,MD,35903,142551,1866,B,178454,3789,1091,4880,0.223565574
20200514,ME,1565,22092,69,B,23657,0,50,50,1
20200514,MI,49582,286301,4787,A+,335883,26432,1191,27623,0.043116244
20200514,MN,13435,115317,663,A+,128752,6199,518,6717,0.077117761
20200514,MO,10317,116793,562,B,127110,2793,175,2968,0.058962264
20200514,MP,19,3306,2,D,3325,285,0,285,0
20200514,MS,10483,94843,480,A,105326,4885,393,5278,0.074460023
20200514,MT,462,24087,16,B,24549,697,0,697,0
20200514,NC,16507,202761,615,A,219268,8120,691,8811,0.078424696
20200514,ND,1647,48599,40,C,50246,1301,0,1301,0
20200514,NE,9075,44266,107,C,53341,3233,383,3616,0.105918142
20200514,NH,3299,35876,150,B,39175,1899,60,1959,0.030627871
20200514,NJ,142704,308992,9946,A+,451696,9102,1144,10246,0.111653328
20200514,NM,5364,109647,231,C,115011,4570,152,4722,0.03218975
20200514,NV,6499,62985,331,B,69484,2707,105,2812,0.037339972
20200514,NY,343051,955706,22170,A,1298757,37460,2390,39850,0.059974906
20200514,OH,26357,206995,1534,B,233352,6862,636,7498,0.084822619
20200514,OK,4962,107221,284,A+,112183,2946,110,3056,0.035994764
20200514,OR,3479,80571,137,A+,84050,0,63,63,1
20200514,PA,59636,251559,4218,C,311195,7388,938,8326,0.11265914
20200514,PR,2427,0,117,B,2427,0,98,98,1
20200514,RI,12016,89585,468,A+,101601,3498,181,3679,0.049198152
20200514,SC,8189,94346,371,A,102535,9133,262,9395,0.027887174
20200514,SD,3792,22681,43,B,26473,569,60,629,0.095389507
20200514,TN,16699,285618,287,A,302317,9071,329,9400,0.035
20200514,TX,43851,543462,1216,A,587313,29089,1448,30537,0.047417886
20200514,UT,6749,153370,75,B,160119,3204,129,3333,0.03870387
20200514,VA,27813,139017,955,A+,166830,4371,1067,5438,0.196211843
20200514,VI,69,1164,6,C,1233,36,0,36,0
20200514,VT,931,20497,53,B,21428,789,1,790,0.001265823
20200514,WA,18496,265162,975,A,283658,5345,247,5592,0.044170243
20200514,WI,11275,122598,434,A+,133873,5487,373,5860,0.063651877
20200514,WV,1427,67286,60,B,68713,2004,29,2033,0.014264634
20200514,WY,701,14729,7,B,15430,345,26,371,0.070080863
20200513,AK,383,30266,10,B,30649,688,0,688,0
20200513,AL,10617,125755,449,B,136372,2847,307,3154,0.097336715
20200513,AR,4164,69051,95,A,73215,2771,0,2771,0
20200513,AS,0,105,0,C,105,0,0,0,0
20200513,AZ,12176,115574,594,A+,127750,4468,440,4908,0.089649552
20200513,CA,71141,994451,2934,B,1065592,30463,1759,32222,0.054590032
20200513,CO,20157,91093,1009,A,111250,2315,278,2593,0.107211724
20200513,CT,34855,108088,3125,B,142943,3997,522,4519,0.115512281
20200513,DC,6584,25074,350,A,31658,509,99,608,0.162828947
20200513,DE,6952,27801,247,B,34753,1251,211,1462,0.144322845
20200513,FL,42402,552361,1898,A+,594763,14680,479,15159,0.03159839
20200513,GA,35332,238572,1505,A+,273904,11028,697,11725,0.059445629
20200513,GU,152,4110,5,C,4262,171,0,171,0
20200513,HI,635,37730,17,B,38365,425,1,426,0.002347418
20200513,IA,13289,72430,306,A+,85719,4054,377,4431,0.085082374
20200513,ID,2293,30835,69,B,33128,390,33,423,0.078014184
20200513,IL,84698,404661,3792,A,489359,15991,1677,17668,0.094917365
20200513,IN,25473,128610,1619,A+,154083,3227,346,3573,0.096837392
20200513,KS,7468,50160,164,A,57628,3167,352,3519,0.100028417
20200513,KY,6853,103781,321,A+,110634,6434,176,6610,0.026626324
20200513,LA,32662,205242,2381,B,237904,9280,612,9892,0.061868176
20200513,MA,80497,329535,5315,A+,410032,7371,1165,8536,0.136480787
20200513,MD,34812,138762,1809,B,173574,3320,751,4071,0.184475559
20200513,ME,1515,22092,66,B,23607,0,38,38,1
20200513,MI,48391,259869,4714,A+,308260,0,370,370,1
20200513,MN,12917,109118,638,A+,122035,778,423,1201,0.352206495
20200513,MO,10142,114000,542,B,124142,2710,136,2846,0.047786367
20200513,MP,19,3021,2,D,3040,167,0,167,0
20200513,MS,10090,89958,465,A,100048,2174,182,2356,0.077249576
20200513,MT,462,23390,16,B,23852,816,1,817,0.00122399
20200513,NC,15816,194641,597,A,210457,7743,470,8213,0.057226348
20200513,ND,1647,47298,40,C,48945,1037,76,1113,0.068283917
20200513,NE,8692,41033,103,B,49725,1662,120,1782,0.067340067
20200513,NH,3239,33977,142,B,37216,1576,79,1655,0.047734139
20200513,NJ,141560,299890,9702,A+,441450,7573,817,8390,0.097377831
20200513,NM,5212,105077,219,C,110289,3425,143,3568,0.040078475
20200513,NV,6394,60278,321,B,66672,2514,83,2597,0.031959954
20200513,NY,340661,918246,22013,A,1258907,31618,2176,33794,0.064390128
20200513,OH,25721,200133,1483,B,225854,7652,471,8123,0.057983504
20200513,OK,4852,104275,278,A+,109127,12896,120,13016,0.009219422
20200513,OR,3416,80571,134,A+,83987,6251,130,6381,0.020372982
20200513,PA,58698,244171,3943,C,302869,6182,707,6889,0.102627377
20200513,PR,2329,0,115,C,2329,0,30,30,1
20200513,RI,11835,86087,462,A+,97922,2462,221,2683,0.082370481
20200513,SC,7927,85213,355,A,93140,0,0,0,0
20200513,SD,3732,22112,39,B,25844,578,69,647,0.106646059
20200513,TN,16370,276547,273,A,292917,8834,259,9093,0.028483449
20200513,TX,42403,514373,1158,A,556776,17249,1355,18604,0.072833799
20200513,UT,6620,150166,75,B,156786,3113,188,3301,0.056952439
20200513,VA,26746,134646,927,A+,161392,5117,946,6063,0.156028369
20200513,VI,69,1128,6,C,1197,13,0,13,0
20200513,VT,930,19708,53,B,20638,601,1,602,0.00166113
20200513,WA,18249,259817,962,A,278066,5999,280,6279,0.044593088
20200513,WI,10902,117111,421,A+,128013,4363,291,4654,0.062526859
20200513,WV,1398,65282,58,B,66680,1584,27,1611,0.016759777
20200513,WY,675,14384,7,B,15059,0,0,0,0
20200512,AK,383,29578,10,B,29961,1279,2,1281,0.00156128
20200512,AL,10310,122908,429,B,133218,3473,301,3774,0.079756227
20200512,AR,4164,66280,95,A,70444,1284,130,1414,0.091937765
20200512,AS,0,105,0,C,105,0,0,0,0
20200512,AZ,11736,111106,562,A+,122842,6022,356,6378,0.05581687
20200512,CA,69382,963988,2847,B,1033370,40030,1443,41473,0.034793721
20200512,CO,19879,88778,987,A,108657,-113,-20,-133,0.15037594
20200512,CT,34333,104091,3041,B,138424,5348,568,5916,0.096010818
20200512,DC,6485,24565,336,A,31050,693,96,789,0.121673004
20200512,DE,6741,26550,237,B,33291,1187,176,1363,0.129126926
20200512,FL,41923,537681,1849,A+,579604,17606,941,18547,0.050735968
20200512,GA,34635,227544,1461,A+,262179,10183,708,10891,0.065007805
20200512,GU,152,3939,5,C,4091,101,1,102,0.009803922
20200512,HI,634,37305,17,B,37939,254,2,256,0.0078125
20200512,IA,12912,68376,289,A+,81288,2957,539,3496,0.154176201
20200512,ID,2260,30445,70,B,32705,533,30,563,0.053285968
20200512,IL,83021,388670,3601,A,471691,25252,4014,29266,0.137155744
20200512,IN,25127,125383,1578,A+,150510,3322,500,3822,0.130821559
20200512,KS,7116,46993,158,A,54109,0,0,0,0
20200512,KY,6677,97347,311,A+,104024,16864,237,17101,0.013858839
20200512,LA,32050,195962,2347,B,228012,6947,235,7182,0.032720691
20200512,MA,79332,322164,5141,A+,401496,5898,870,6768,0.128546099
20200512,MD,34061,135442,1756,B,169503,4035,688,4723,0.145670125
20200512,ME,1477,22092,65,B,23569,0,15,15,1
20200512,MI,48021,259869,4674,A+,307890,8473,469,8942,0.052449117
20200512,MN,12494,108340,614,A,120834,4358,695,5053,0.137542054
20200512,MO,10006,111290,524,B,121296,5588,88,5676,0.015503876
20200512,MP,19,2854,2,D,2873,178,0,178,0
20200512,MS,9908,87784,457,A,97692,1573,234,1807,0.129496403
20200512,MT,461,22574,16,B,23035,461,2,463,0.004319654
20200512,NC,15346,186898,577,A,202244,6078,301,6379,0.047186079
20200512,ND,1571,46261,38,C,47832,765,53,818,0.064792176
20200512,NE,8572,39371,100,B,47943,1447,257,1704,0.150821596
20200512,NH,3160,32401,133,B,35561,678,0,678,0
20200512,NJ,140743,292317,9508,A+,433060,6329,798,7127,0.11196857
20200512,NM,5069,101652,208,C,106721,4017,206,4223,0.048780488
20200512,NV,6311,57764,312,C,64075,3832,159,3991,0.039839639
20200512,NY,338485,886628,21845,A,1225113,19032,1430,20462,0.069885642
20200512,OH,25250,192481,1436,B,217731,6728,473,7201,0.065685321
20200512,OK,4732,91379,278,A+,96111,0,119,119,1
20200512,OR,3286,74320,130,A+,77606,0,0,0,0
20200512,PA,57991,237989,3806,C,295980,6285,837,7122,0.117523168
20200512,PR,2299,0,114,C,2299,0,43,43,1
20200512,RI,11614,83625,444,A+,95239,1743,164,1907,0.085998951
20200512,SC,7927,85213,355,A,93140,8409,274,8683,0.031555914
20200512,SD,3663,21534,39,B,25197,570,49,619,0.079159935
20200512,TN,16111,267713,265,A,283824,9980,567,10547,0.053759363
20200512,TX,41048,497124,1133,A,538172,11296,1179,12475,0.094509018
20200512,UT,6432,147053,73,B,153485,2830,70,2900,0.024137931
20200512,VA,25800,129529,891,A+,155329,3982,730,4712,0.154923599
20200512,VI,69,1115,6,C,1184,5,0,5,0
20200512,VT,929,19107,53,B,20036,310,2,312,0.006410256
20200512,WA,17969,253818,945,A,271787,5869,241,6110,0.039443535
20200512,WI,10611,112748,418,A+,123359,4715,193,4908,0.039323553
20200512,WV,1371,63698,57,C,65069,1595,5,1600,0.003125
20200512,WY,675,14384,7,B,15059,2981,13,2994,0.004342017
20200511,AK,381,28299,10,C,28680,1314,2,1316,0.001519757
20200511,AL,10009,119435,401,B,129444,1791,232,2023,0.114681167
20200511,AR,4034,64996,94,A,69030,3215,287,3502,0.08195317
20200511,AS,0,105,0,D,105,22,0,22,0
20200511,AZ,11380,105084,542,A+,116464,5826,261,6087,0.042878265
20200511,CA,67939,923958,2770,B,991897,34974,1259,36233,0.03474733
20200511,CO,19899,88891,981,B,108790,4517,196,4713,0.0415871
20200511,CT,33765,98743,3008,B,132508,2105,211,2316,0.091105354
20200511,DC,6389,23872,328,A,30261,574,117,691,0.169319826
20200511,DE,6565,25363,225,B,31928,771,118,889,0.132733408
20200511,FL,40982,520075,1805,B,561057,21723,386,22109,0.017458953
20200511,GA,33927,217361,1441,A,251288,7255,486,7741,0.062782586
20200511,GU,151,3838,5,C,3989,195,0,195,0
20200511,HI,632,37051,17,B,37683,412,1,413,0.002421308
20200511,IA,12373,65419,271,A+,77792,3204,414,3618,0.114427861
20200511,ID,2230,29912,67,B,32142,0,0,0,0
20200511,IL,79007,363418,3459,A,442425,11175,1266,12441,0.101760309
20200511,IN,24627,122061,1540,A+,146688,6158,501,6659,0.075236522
20200511,KS,7116,46993,158,A,54109,1436,168,1604,0.104738155
20200511,KY,6440,80483,304,A,86923,0,0,0,0
20200511,LA,31815,189015,2308,B,220830,4743,215,4958,0.04336426
20200511,MA,78462,316266,5108,A,394728,5670,669,6339,0.105537151
20200511,MD,33373,131407,1683,A,164780,4063,786,4849,0.162095277
20200511,ME,1462,22092,65,B,23554,0,26,26,1
20200511,MI,47552,251396,4584,A+,298948,12856,414,13270,0.031198191
20200511,MN,11799,103982,591,A,115781,4165,528,4693,0.112507991
20200511,MO,9918,105702,488,B,115620,0,74,74,1
20200511,MP,19,2676,2,D,2695,355,3,358,0.008379888
20200511,MS,9674,86211,435,A,95885,14110,173,14283,0.012112301
20200511,MT,459,22113,16,C,22572,867,1,868,0.001152074
20200511,NC,15045,180820,550,B,195865,3449,281,3730,0.075335121
20200511,ND,1518,45496,36,C,47014,2118,27,2145,0.012587413
20200511,NE,8315,37924,98,D,46239,589,81,670,0.120895522
20200511,NH,3160,31723,133,B,34883,1281,149,1430,0.104195804
20200511,NJ,139945,285988,9310,A+,425933,112073,1413,113486,0.012450875
20200511,NM,4863,97635,200,C,102498,5360,85,5445,0.015610652
20200511,NV,6152,53932,306,C,60084,1221,54,1275,0.042352941
20200511,NY,337055,867596,21640,A,1204651,19993,1660,21653,0.076663742
20200511,OH,24777,185753,1357,B,210530,4972,696,5668,0.122794637
20200511,OK,4613,91379,274,A+,95992,0,24,24,1
20200511,OR,3286,74320,130,A+,77606,2041,58,2099,0.027632206
20200511,PA,57154,231704,3731,C,288858,3932,543,4475,0.121340782
20200511,PR,2256,0,113,D,2256,0,58,58,1
20200511,RI,11450,81882,430,A+,93332,1943,176,2119,0.083058046
20200511,SC,7653,76804,331,B,84457,0,0,0,0
20200511,SD,3614,20964,34,C,24578,587,97,684,0.141812865
20200511,TN,15544,257733,251,B,273277,10849,559,11408,0.049000701
20200511,TX,39869,485828,1100,B,525697,22921,1000,23921,0.041804272
20200511,UT,6362,144223,68,B,150585,3964,111,4075,0.027239264
20200511,VA,25070,125547,850,A+,150617,6573,989,7562,0.130785506
20200511,VI,69,1110,5,C,1179,8,0,8,0
20200511,VT,927,18797,53,B,19724,630,1,631,0.001584786
20200511,WA,17728,247949,931,B,265677,5610,283,5893,0.048023078
20200511,WI,10418,108033,409,A+,118451,2870,199,3069,0.064841968
20200511,WV,1366,62103,54,C,63469,819,6,825,0.007272727
20200511,WY,662,11403,7,C,12065,0,1,1,1
20200510,AK,379,26985,10,C,27364,914,1,915,0.001092896
20200510,AL,9777,117644,393,B,127421,1717,210,1927,0.108977686
20200510,AR,3747,61781,88,B,65528,0,0,0,0
20200510,AS,0,83,0,D,83,0,0,0,0
20200510,AZ,11119,99258,536,A+,110377,4408,159,4567,0.034814977
20200510,CA,66680,888984,2745,B,955664,40975,2119,43094,0.049171578
20200510,CO,19703,84374,967,B,104077,6429,876,7305,0.119917864
20200510,CT,33554,96638,2967,B,130192,6053,570,6623,0.086063717
20200510,DC,6272,23298,323,A+,29570,1217,170,1387,0.122566691
20200510,DE,6447,24592,224,B,31039,1573,170,1743,0.097532989
20200510,FL,40596,498352,1791,B,538948,10622,595,11217,0.053044486
20200510,GA,33441,210106,1405,A,243547,7314,909,8223,0.110543597
20200510,GU,151,3643,5,C,3794,0,0,0,0
20200510,HI,631,36639,17,B,37270,1006,2,1008,0.001984127
20200510,IA,11959,62215,265,A+,74174,2410,288,2698,0.106745738
20200510,ID,2230,29912,67,B,32142,311,25,336,0.074404762
20200510,IL,77741,352243,3406,A,429984,11997,1656,13653,0.121292024
20200510,IN,24126,115903,1508,A+,140029,3949,394,4343,0.0907207
20200510,KS,6948,45557,157,A,52505,2375,197,2572,0.07659409
20200510,KY,6440,80483,304,A,86923,324,152,476,0.319327731
20200510,LA,31600,184272,2286,B,215872,3532,183,3715,0.049259758
20200510,MA,77793,310596,4979,A,388389,10802,1050,11852,0.088592643
20200510,MD,32587,127344,1644,A,159931,2850,1053,3903,0.269792467
20200510,ME,1436,22092,64,B,23528,0,28,28,1
20200510,MI,47138,238540,4551,A+,285678,11810,382,12192,0.031332021
20200510,MN,11271,99817,578,A,111088,4344,481,4825,0.099689119
20200510,MO,9844,105702,482,B,115546,6470,178,6648,0.02677497
20200510,MP,16,2321,2,D,2337,0,0,0,0
20200510,MS,9501,72101,430,A,81602,0,123,123,1
20200510,MT,458,21246,16,C,21704,375,0,375,0
20200510,NC,14764,177371,547,B,192135,5369,404,5773,0.069980946
20200510,ND,1491,43378,35,C,44869,909,27,936,0.028846154
20200510,NE,8234,37335,96,D,45569,2190,403,2593,0.155418434
20200510,NH,3011,30442,131,B,33453,1091,64,1155,0.055411255
20200510,NJ,138532,173915,9255,A+,312447,5794,1447,7241,0.199834277
20200510,NM,4778,92275,191,C,97053,3686,105,3791,0.027697178
20200510,NV,6098,52711,306,C,58809,2628,70,2698,0.025945145
20200510,NY,335395,847603,21478,A,1182998,26957,2273,29230,0.077762573
20200510,OH,24081,180781,1341,B,204862,7808,384,8192,0.046875
20200510,OK,4589,91379,272,A+,95968,0,99,99,1
20200510,OR,3228,72279,127,A+,75507,819,68,887,0.076662909
20200510,PA,56611,227772,3707,C,284383,5981,1295,7276,0.177982408
20200510,PR,2198,0,111,D,2198,0,25,25,1
20200510,RI,11274,79939,422,A+,91213,3113,285,3398,0.083872866
20200510,SC,7653,76804,331,B,84457,3372,122,3494,0.034917001
20200510,SD,3517,20377,34,C,23894,818,124,942,0.13163482
20200510,TN,14985,246884,243,B,261869,8904,217,9121,0.023791251
20200510,TX,38869,462907,1088,B,501776,11473,1009,12482,0.080836404
20200510,UT,6251,140259,67,B,146510,3068,148,3216,0.0460199
20200510,VA,24081,118974,839,A+,143055,5021,885,5906,0.149847613
20200510,VI,69,1102,4,C,1171,78,1,79,0.012658228
20200510,VT,926,18167,53,B,19093,477,0,477,0
20200510,WA,17445,242339,921,B,259784,1225,51,1276,0.039968652
20200510,WI,10219,105163,400,A+,115382,3228,280,3508,0.07981756
20200510,WV,1360,61284,54,C,62644,1622,25,1647,0.015179114
20200510,WY,661,11403,7,C,12064,0,17,17,1
20200509,AK,378,26071,10,C,26449,975,1,976,0.00102459
20200509,AL,9567,115927,388,B,125494,5034,346,5380,0.064312268
20200509,AR,3747,61781,88,B,65528,1481,53,1534,0.034550196
20200509,AS,0,83,0,D,83,0,0,0,0
20200509,AZ,10960,94850,532,A+,105810,4251,434,4685,0.092636073
20200509,CA,64561,848009,2678,B,912570,35249,2049,37298,0.054935921
20200509,CO,18827,77945,960,B,96772,2210,26,2236,0.011627907
20200509,CT,32984,90585,2932,B,123569,2455,573,3028,0.189233818
20200509,DC,6102,22081,311,A+,28183,865,203,1068,0.190074906
20200509,DE,6277,23019,221,B,29296,866,166,1032,0.160852713
20200509,FL,40001,487730,1785,B,527731,13588,802,14390,0.055733148
20200509,GA,32532,202792,1400,A,235324,7331,426,7757,0.054918138
20200509,GU,151,3643,5,C,3794,17,0,17,0
20200509,HI,629,35633,17,C,36262,-356,0,-356,0
20200509,IA,11671,59805,252,A+,71476,1001,214,1215,0.176131687
20200509,ID,2205,29601,67,B,31806,509,27,536,0.050373134
20200509,IL,76085,340246,3349,A,416331,14292,2325,16617,0.139916953
20200509,IN,23732,111954,1490,A+,135686,4972,586,5558,0.105433609
20200509,KS,6751,43182,157,A,49933,1975,250,2225,0.112359551
20200509,KY,6288,80159,298,A,86447,4887,159,5046,0.031510107
20200509,LA,31417,180740,2267,B,212157,9179,562,9741,0.057694282
20200509,MA,76743,299794,4840,A,376537,9104,1410,10514,0.134106905
20200509,MD,31534,124494,1614,A,156028,2792,1049,3841,0.273105962
20200509,ME,1408,22092,64,B,23500,0,34,34,1
20200509,MI,46756,226730,4526,A+,273486,12803,430,13233,0.032494521
20200509,MN,10790,95473,558,A,106263,4291,702,4993,0.140596836
20200509,MO,9666,99232,472,B,108898,0,177,177,1
20200509,MP,16,2321,2,D,2337,0,1,1,1
20200509,MS,9378,72101,421,A,81479,0,288,288,1
20200509,MT,458,20871,16,C,21329,384,0,384,0
20200509,NC,14360,172002,544,B,186362,7257,492,7749,0.063492063
20200509,ND,1464,42469,35,C,43933,1393,39,1432,0.027234637
20200509,NE,7831,35145,92,D,42976,1923,641,2564,0.25
20200509,NH,2947,29351,121,B,32298,1522,104,1626,0.06396064
20200509,NJ,137085,168121,9116,A+,305206,4816,1631,6447,0.252985885
20200509,NM,4673,88589,181,C,93262,4050,180,4230,0.042553191
20200509,NV,6028,50083,301,D,56111,2623,144,2767,0.052041923
20200509,NY,333122,820646,21271,B,1153768,29510,2715,32225,0.084251358
20200509,OH,23697,172973,1331,B,196670,11673,681,12354,0.055123847
20200509,OK,4490,91379,270,A+,95869,5946,66,6012,0.010978044
20200509,OR,3160,71460,127,A+,74620,1835,92,1927,0.047742605
20200509,PA,55316,221791,3688,C,277107,5470,1078,6548,0.164630422
20200509,PR,2173,0,108,C,2173,0,17,17,1
20200509,RI,10989,76826,418,A+,87815,2339,210,2549,0.082385249
20200509,SC,7531,73432,330,B,80963,7132,389,7521,0.051721845
20200509,SD,3393,19559,34,C,22952,1410,249,1659,0.150090416
20200509,TN,14768,237980,242,B,252748,8843,327,9170,0.03565976
20200509,TX,37860,451434,1049,B,489294,10925,1251,12176,0.102743101
20200509,UT,6103,137191,66,B,143294,4422,184,4606,0.039947894
20200509,VA,23196,113953,827,A+,137149,6350,854,7204,0.118545253
20200509,VI,68,1024,4,C,1092,0,0,0,0
20200509,VT,926,17690,53,B,18616,468,8,476,0.016806723
20200509,WA,17394,241114,905,B,258508,2136,121,2257,0.053610988
20200509,WI,9939,101935,398,A+,111874,4670,349,5019,0.069535764
20200509,WV,1335,59662,53,C,60997,1536,25,1561,0.016015375
20200509,WY,644,11403,7,C,12047,0,9,9,1
20200508,AK,377,25096,10,C,25473,1129,3,1132,0.002650177
20200508,AL,9221,110893,375,B,120114,4618,323,4941,0.065371382
20200508,AR,3694,60300,88,B,63994,3916,83,3999,0.020755189
20200508,AS,0,83,0,F,83,0,0,0,0
20200508,AZ,10526,90599,517,A+,101125,4110,581,4691,0.123854189
20200508,CA,62512,812760,2585,B,875272,30500,1898,32398,0.058583863
20200508,CO,18801,75735,961,B,94536,2218,971,3189,0.304484164
20200508,CT,32411,88130,2874,B,120541,3740,627,4367,0.143576826
20200508,DC,5899,21216,304,A+,27115,1014,245,1259,0.194598888
20200508,DE,6111,22153,213,B,28264,766,172,938,0.18336887
20200508,FL,39199,474142,1738,C,513341,20020,371,20391,0.018194301
20200508,GA,32106,195461,1377,A,227567,9597,667,10264,0.064984412
20200508,GU,151,3626,5,D,3777,62,0,62,0
20200508,HI,629,35989,17,B,36618,1074,3,1077,0.002785515
20200508,IA,11457,58804,243,A+,70261,3436,398,3834,0.103808033
20200508,ID,2178,29092,67,B,31270,360,20,380,0.052631579
20200508,IL,73760,325954,3241,A,399714,17784,2887,20671,0.139664264
20200508,IN,23146,106982,1447,A+,130128,4703,643,5346,0.120276842
20200508,KS,6501,41207,152,A,47708,2529,357,2886,0.123700624
20200508,KY,6129,75272,294,A,81401,2600,195,2795,0.069767442
20200508,LA,30855,171561,2227,B,202416,1446,203,1649,0.123104912
20200508,MA,75333,290690,4702,A,366023,12779,1612,14391,0.112014453
20200508,MD,30485,121702,1560,A,152187,2476,1111,3587,0.309729579
20200508,ME,1374,22092,63,B,23466,0,44,44,1
20200508,MI,46326,213927,4393,A+,260253,12511,680,13191,0.051550299
20200508,MN,10088,91182,534,A,101270,3126,723,3849,0.187840998
20200508,MO,9489,99232,449,B,108721,4951,148,5099,0.029025299
20200508,MP,15,2321,2,D,2336,538,0,538,0
20200508,MS,9090,72101,409,A,81191,0,404,404,1
20200508,MT,458,20487,16,C,20945,696,2,698,0.00286533
20200508,NC,13868,164745,527,B,178613,6814,471,7285,0.064653397
20200508,ND,1425,41076,33,C,42501,1580,54,1634,0.033047736
20200508,NE,7190,33222,90,D,40412,2235,419,2654,0.157874906
20200508,NH,2843,27829,114,B,30672,1763,103,1866,0.055198285
20200508,NJ,135454,163305,8952,A+,298759,4282,1819,6101,0.298147845
20200508,NM,4493,84539,172,C,89032,3146,202,3348,0.060334528
20200508,NV,5884,47460,293,D,53344,1869,118,1987,0.059386009
20200508,NY,330407,791136,21045,B,1121543,28869,2758,31627,0.087203971
20200508,OH,23016,161300,1306,B,184316,7372,885,8257,0.107181785
20200508,OK,4424,85433,266,A+,89857,2876,94,2970,0.031649832
20200508,OR,3068,69625,124,A+,72693,2156,79,2235,0.035346756
20200508,PA,54238,216321,3616,C,270559,6448,1323,7771,0.170248359
20200508,PR,2156,0,107,C,2156,0,125,125,1
20200508,RI,10779,74487,399,A+,85266,2699,249,2948,0.084464043
20200508,SC,7142,66300,316,B,73442,-4246,206,-4040,-0.050990099
20200508,SD,3144,18149,31,C,21293,940,239,1179,0.202714165
20200508,TN,14441,229137,241,B,243578,6905,345,7250,0.047586207
20200508,TX,36609,440509,1004,B,477118,20737,1219,21956,0.055520131
20200508,UT,5919,132769,61,B,138688,3950,195,4145,0.047044632
20200508,VA,22342,107603,812,A+,129945,6021,772,6793,0.113646401
20200508,VI,68,1024,4,C,1092,34,2,36,0.055555556
20200508,VT,918,17222,53,B,18140,532,2,534,0.003745318
20200508,WA,17273,238978,891,B,256251,5769,245,6014,0.040738277
20200508,WI,9590,97265,384,A+,106855,4230,375,4605,0.081433225
20200508,WV,1310,58126,51,C,59436,1892,23,1915,0.012010444
20200508,WY,635,11403,7,C,12038,0,4,4,1
20200507,AK,374,23967,10,C,24341,684,2,686,0.002915452
20200507,AL,8898,106275,349,B,115173,5340,317,5657,0.056036769
20200507,AR,3611,56384,87,B,59995,949,43,992,0.043346774
20200507,AS,0,83,0,F,83,0,0,0,0
20200507,AZ,9945,86489,450,A+,96434,4459,238,4697,0.050670641
20200507,CA,60614,782260,2504,B,842874,32039,1799,33838,0.053165081
20200507,CO,17830,73517,921,B,91347,4905,466,5371,0.086762242
20200507,CT,31784,84390,2797,B,116174,3938,789,4727,0.166913476
20200507,DC,5654,20202,285,A+,25856,679,193,872,0.221330275
20200507,DE,5939,21387,202,B,27326,697,161,858,0.187645688
20200507,FL,38828,454122,1667,C,492950,12073,826,12899,0.064035972
20200507,GA,31439,185864,1336,A,217303,12423,743,13166,0.056433237
20200507,GU,151,3564,5,F,3715,88,0,88,0
20200507,HI,626,34915,17,B,35541,341,1,342,0.002923977
20200507,IA,11059,55368,231,A+,66427,2601,655,3256,0.201167076
20200507,ID,2158,28732,66,B,30890,314,31,345,0.089855072
20200507,IL,70873,308170,3111,A,379043,15142,2641,17783,0.148512624
20200507,IN,22503,102279,1414,A+,124782,3653,633,4286,0.147690154
20200507,KS,6144,38678,147,A,44822,2298,410,2708,0.15140325
20200507,KY,5934,72672,283,A,78606,17480,112,17592,0.00636653
20200507,LA,30652,170115,2208,B,200767,5842,253,6095,0.041509434
20200507,MA,73721,277911,4552,A,351632,10297,1696,11993,0.141415826
20200507,MD,29374,119226,1503,A,148600,3377,1211,4588,0.263949433
20200507,ME,1330,22092,62,B,23422,0,76,76,1
20200507,MI,45646,201416,4343,A+,247062,13239,592,13831,0.0428024
20200507,MN,9365,88056,508,A,97421,3403,786,4189,0.18763428
20200507,MO,9341,94281,418,B,103622,2636,239,2875,0.083130435
20200507,MP,15,1783,2,D,1798,0,0,0,0
20200507,MS,8686,72101,396,A,80787,0,262,262,1
20200507,MT,456,19791,16,C,20247,543,0,543,0
20200507,NC,13397,157931,507,B,171328,6207,639,6846,0.093339176
20200507,ND,1371,39496,31,C,40867,2187,48,2235,0.02147651
20200507,NE,6771,30987,86,D,37758,1297,333,1630,0.204294479
20200507,NH,2740,26066,111,B,28806,969,104,1073,0.096924511
20200507,NJ,133635,159023,8801,A+,292658,1993,1745,3738,0.46682718
20200507,NM,4291,81393,169,C,85684,2280,153,2433,0.062885327
20200507,NV,5766,45591,286,D,51357,1979,103,2082,0.049471662
20200507,NY,327649,762267,20828,B,1089916,30324,3671,33995,0.107986469
20200507,OH,22131,153928,1271,B,176059,6575,555,7130,0.077840112
20200507,OK,4330,82557,260,A+,86887,3868,129,3997,0.032274206
20200507,OR,2989,67469,121,A+,70458,2409,73,2482,0.029411765
20200507,PA,52915,209873,3416,C,262788,5378,1070,6448,0.165942928
20200507,PR,2031,0,102,D,2031,0,63,63,1
20200507,RI,10530,71788,388,A+,82318,2620,325,2945,0.110356537
20200507,SC,6936,70546,305,B,77482,0,0,0,0
20200507,SD,2905,17209,31,C,20114,572,126,698,0.180515759
20200507,TN,14096,222232,237,B,236328,9069,158,9227,0.017123659
20200507,TX,35390,419772,973,B,455162,15256,968,16224,0.059664694
20200507,UT,5724,128819,61,B,134543,3412,129,3541,0.036430387
20200507,VA,21570,101582,769,A+,123152,8130,1314,9444,0.139135959
20200507,VI,66,990,4,C,1056,0,0,0,0
20200507,VT,916,16690,53,B,17606,409,2,411,0.00486618
20200507,WA,17028,233209,870,B,250237,5518,243,5761,0.042180177
20200507,WI,9215,93035,374,A+,102250,5209,314,5523,0.05685316
20200507,WV,1287,56234,51,C,57521,1698,39,1737,0.022452504
20200507,WY,631,11403,7,C,12034,0,27,27,1
20200506,AK,372,23283,10,C,23655,962,1,963,0.001038422
20200506,AL,8581,100935,340,B,109516,2454,296,2750,0.107636364
20200506,AR,3568,55435,85,B,59003,4296,72,4368,0.016483516
20200506,AS,0,83,0,F,83,0,0,0,0
20200506,AZ,9707,82030,426,A+,91737,3075,402,3477,0.115616911
20200506,CA,58815,750221,2412,B,809036,26531,2603,29134,0.089345782
20200506,CO,17364,68612,903,B,85976,515,457,972,0.470164609
20200506,CT,30995,80452,2718,B,111447,2430,374,2804,0.133380884
20200506,DC,5461,19523,277,A+,24984,516,139,655,0.21221374
20200506,DE,5778,20690,193,B,26468,1381,407,1788,0.227628635
20200506,FL,38002,442049,1605,C,480051,13797,563,14360,0.039206128
20200506,GA,30696,173441,1311,A,204137,2269,985,3254,0.302704364
20200506,GU,151,3476,5,F,3627,135,2,137,0.01459854
20200506,HI,625,34574,17,B,35199,1196,4,1200,0.003333333
20200506,IA,10404,52767,219,B,63171,2309,293,2602,0.112605688
20200506,ID,2127,28418,65,C,30545,216,21,237,0.088607595
20200506,IL,68232,293028,2974,A,361260,12704,2270,14974,0.1515961
20200506,IN,21870,98626,1377,A+,120496,3825,837,4662,0.17953668
20200506,KS,5734,36380,144,A,42114,1746,276,2022,0.136498516
20200506,KY,5822,55192,275,A,61014,390,577,967,0.596690796
20200506,LA,30399,164273,2115,B,194672,6038,403,6441,0.062567924
20200506,MA,72025,267614,4420,A,339639,4536,1754,6290,0.278855326
20200506,MD,28163,115849,1437,A,144012,2863,1046,3909,0.267587618
20200506,ME,1254,22092,62,B,23346,2546,28,2574,0.010878011
20200506,MI,45054,188177,4250,A+,233231,9738,657,10395,0.063203463
20200506,MN,8579,84653,485,A,93232,4495,728,5223,0.139383496
20200506,MO,9102,91645,396,B,100747,5495,186,5681,0.032740715
20200506,MP,15,1783,2,D,1798,0,1,1,1
20200506,MS,8424,72101,374,B,80525,0,217,217,1
20200506,MT,456,19248,16,C,19704,4432,0,4432,0
20200506,NC,12758,151724,477,B,164482,12180,502,12682,0.039583662
20200506,ND,1323,37309,31,C,38632,2154,57,2211,0.02578019
20200506,NE,6438,29690,82,D,36128,1164,355,1519,0.233706386
20200506,NH,2636,25097,92,B,27733,815,48,863,0.05561993
20200506,NJ,131890,157030,8549,A+,288920,0,1297,1297,1
20200506,NM,4138,79113,162,C,83251,1424,107,1531,0.069888961
20200506,NV,5663,43612,276,D,49275,1322,69,1391,0.049604601
20200506,NY,323978,731943,19877,B,1055921,24236,2786,27022,0.103101177
20200506,OH,21576,147353,1225,B,168929,7587,607,8194,0.074078594
20200506,OK,4201,78689,253,A,82890,3399,74,3473,0.021307227
20200506,OR,2916,65060,115,A+,67976,2475,77,2552,0.030172414
20200506,PA,51845,204495,3106,C,256340,4570,888,5458,0.162696959
20200506,PR,1968,0,99,D,1968,0,44,-9269,-0.004747006
20200506,RI,10205,69168,370,A+,79373,2666,272,2938,0.092579986
20200506,SC,6936,70546,305,B,77482,9532,179,9711,0.018432705
20200506,SD,2779,16637,29,C,19416,336,58,394,0.147208122
20200506,TN,13938,213163,239,B,227101,7991,248,8239,0.03010074
20200506,TX,34422,404516,948,B,438938,10675,1053,11728,0.08978513
20200506,UT,5595,125407,58,C,131002,4141,146,4287,0.03405645
20200506,VA,20256,93452,713,A+,113708,0,0,0,0
20200506,VI,66,990,4,C,1056,17,0,17,0
20200506,VT,914,16281,52,B,17195,216,5,221,0.022624434
20200506,WA,16785,227691,862,B,244476,6662,275,6937,0.039642497
20200506,WI,8901,87826,362,A+,96727,3859,335,4194,0.079876013
20200506,WV,1248,54536,50,C,55784,951,10,961,0.010405827
20200506,WY,604,11403,7,C,12007,1084,8,1092,0.007326007
20200505,AK,371,22321,9,C,22692,968,1,969,0.001031992
20200505,AL,8285,98481,313,B,106766,3389,260,3649,0.071252398
20200505,AR,3496,51139,83,B,54635,155,38,193,0.196891192
20200505,AS,0,83,0,F,83,0,0,0,0
20200505,AZ,9305,78955,395,A+,88260,2621,386,3007,0.128367143
20200505,CA,56212,723690,2317,B,779902,30753,1275,32028,0.039808917
20200505,CO,16907,68097,851,B,85004,1642,272,1914,0.142110763
20200505,CT,30621,78022,2633,B,108643,4816,1334,6150,0.216910569
20200505,DC,5322,19007,264,A+,24329,382,152,534,0.284644195
20200505,DE,5371,19309,187,B,24680,487,83,570,0.145614035
20200505,FL,37439,428252,1536,C,465691,20879,542,21421,0.025302273
20200505,GA,29711,171172,1288,A,200883,17215,343,17558,0.019535255
20200505,GU,149,3341,5,F,3490,99,0,99,0
20200505,HI,621,33378,17,B,33999,132,1,133,0.007518797
20200505,IA,10111,50458,207,B,60569,3000,408,3408,0.11971831
20200505,ID,2106,28202,64,C,30308,456,45,501,0.089820359
20200505,IL,65962,280324,2838,A,346286,11017,2122,13139,0.16150392
20200505,IN,21033,94801,1326,A+,115834,2011,526,2537,0.207331494
20200505,KS,5458,34634,137,A,40092,1276,213,1489,0.143049026
20200505,KY,5245,54802,261,A,60047,1523,115,1638,0.07020757
20200505,LA,29996,158235,2115,B,188231,6977,323,7300,0.044246575
20200505,MA,70271,263078,4212,A,333349,7897,1184,9081,0.130382117
20200505,MD,27117,112986,1390,A,140103,2399,709,3108,0.228120978
20200505,ME,1226,19546,61,B,20772,0,21,21,1
20200505,MI,44397,178439,4179,A+,222836,0,447,447,1
20200505,MN,7851,80158,455,A,88009,1451,617,2068,0.298355899
20200505,MO,8916,86150,377,A,95066,3453,162,3615,0.044813278
20200505,MP,14,1783,2,D,1797,462,0,462,0
20200505,MS,8207,72101,342,B,80308,301,330,631,0.522979398
20200505,MT,456,14816,16,C,15272,185,-1,184,-0.005434783
20200505,NC,12256,139544,452,B,151800,4953,408,5361,0.076105204
20200505,ND,1266,35155,25,C,36421,1626,41,1667,0.024595081
20200505,NE,6083,28526,78,D,34609,682,173,855,0.202339181
20200505,NH,2588,24282,86,C,26870,0,0,0,0
20200505,NJ,130593,157030,8244,A+,287623,8079,2324,10403,0.223397097
20200505,NM,4031,77689,156,C,81720,3562,181,3743,0.048356933
20200505,NV,5594,42290,268,D,47884,1615,103,1718,0.059953434
20200505,NY,321192,707707,19645,B,1028899,19350,2239,21589,0.103710223
20200505,OH,20969,139766,1135,B,160735,5085,495,5580,0.088709677
20200505,OK,4127,75290,247,A,79417,15486,83,15569,0.005331107
20200505,OR,2839,62585,113,A+,65424,1887,80,1967,0.040671073
20200505,PA,50957,199925,3012,B,250882,4427,865,5292,0.163454271
20200505,PR,1924,9313,99,D,11237,0,81,81,1
20200505,RI,9933,66502,355,A+,76435,2018,281,2299,0.122227055
20200505,SC,6757,61014,283,B,67771,3452,131,3583,0.036561541
20200505,SD,2721,16301,24,C,19022,256,53,309,0.171521036
20200505,TN,13690,205172,226,B,218862,7300,119,7419,0.016039898
20200505,TX,33369,393841,906,B,427210,18775,1037,19812,0.052342015
20200505,UT,5449,121266,56,C,126715,1922,132,2054,0.064264849
20200505,VA,20256,93452,713,A+,113708,651,764,1415,0.539929329
20200505,VI,66,973,4,C,1039,8,0,8,0
20200505,VT,909,16065,52,B,16974,176,3,179,0.016759777
20200505,WA,16510,221029,841,B,237539,5938,248,6186,0.040090527
20200505,WI,8566,83967,353,A,92533,3500,330,3830,0.08616188
20200505,WV,1238,53585,50,C,54823,1552,32,1584,0.02020202
20200505,WY,596,10319,7,C,10915,451,10,461,0.021691974
20200504,AK,370,21353,9,C,21723,143,2,145,0.013793103
20200504,AL,8025,95092,296,B,103117,10317,300,10617,0.02825657
20200504,AR,3458,50984,81,B,54442,1525,27,1552,0.017396907
20200504,AS,0,83,0,F,83,26,0,26,0
20200504,AZ,8919,76334,362,A+,85253,3855,279,4134,0.067489115
20200504,CA,54937,692937,2254,B,747874,30802,1321,32123,0.041123183
20200504,CO,16635,66455,842,B,83090,2774,410,3184,0.128768844
20200504,CT,29287,73206,2495,B,102493,0,0,0,0
20200504,DC,5170,18625,258,A+,23795,539,154,693,0.222222222
20200504,DE,5288,18822,182,B,24110,293,80,373,0.214477212
20200504,FL,36897,407373,1423,C,444270,15262,819,16081,0.050929669
20200504,GA,29368,153957,1222,A,183325,7463,766,8229,0.09308543
20200504,GU,149,3242,5,F,3391,90,-1,89,-0.011235955
20200504,HI,620,33246,17,B,33866,916,0,916,0
20200504,IA,9703,47458,188,B,57161,3441,534,3975,0.134339623
20200504,ID,2061,27746,64,C,29807,0,0,0,0
20200504,IL,63840,269307,2662,A,333147,11493,2341,13834,0.16922076
20200504,IN,20507,92790,1264,A+,113297,3864,574,4438,0.129337539
20200504,KS,5245,33358,136,A,38603,1610,215,1825,0.117808219
20200504,KY,5130,53279,253,A,58409,509,251,760,0.330263158
20200504,LA,29673,151258,2064,B,180931,4438,333,4771,0.069796688
20200504,MA,69087,255181,4090,A,324268,8622,1000,9622,0.103928497
20200504,MD,26408,110587,1317,A,136995,3255,946,4201,0.22518448
20200504,ME,1205,19546,57,B,20751,0,20,20,1
20200504,MI,43950,178439,4049,A+,222389,9661,196,9857,0.019884346
20200504,MN,7234,78707,428,A,85941,2738,571,3309,0.172559686
20200504,MO,8754,82697,358,A,91451,8107,368,8475,0.043421829
20200504,MP,14,1321,2,D,1335,0,0,0,0
20200504,MS,7877,71800,310,B,79677,1757,327,2084,0.156909789
20200504,MT,457,14631,16,C,15088,79,2,81,0.024691358
20200504,NC,11848,134591,430,B,146439,2420,184,2604,0.070660522
20200504,ND,1225,33529,25,C,34754,1367,34,1401,0.02426838
20200504,NE,5910,27844,78,D,33754,1908,584,2492,0.23434992
20200504,NH,2588,24282,86,C,26870,-1682,159,-1523,-0.104399212
20200504,NJ,128269,148951,7910,A+,277220,629,1525,2154,0.707985144
20200504,NM,3850,74127,151,C,77977,2915,118,3033,0.038905374
20200504,NV,5491,40675,262,D,46166,832,65,897,0.072463768
20200504,NY,318953,688357,19415,B,1007310,18861,2538,21399,0.118603673
20200504,OH,20474,134681,1056,B,155155,4429,560,4989,0.112246943
20200504,OK,4044,59804,238,A,63848,0,72,72,1
20200504,OR,2759,60698,109,A+,63457,1324,79,1403,0.056307912
20200504,PA,50092,195498,2458,B,245590,4124,825,4949,0.166700344
20200504,PR,1843,9313,97,D,11156,0,35,35,1
20200504,RI,9652,64484,341,A+,74136,2034,175,2209,0.079221367
20200504,SC,6626,57562,275,B,64188,0,0,0,0
20200504,SD,2668,16045,21,C,18713,259,37,296,0.125
20200504,TN,13571,197872,219,B,211443,6442,394,6836,0.057636044
20200504,TX,32332,375066,884,B,407398,16054,784,16838,0.046561349
20200504,UT,5317,119344,50,C,124661,2417,142,2559,0.055490426
20200504,VA,19492,92801,684,A+,112293,3470,821,4291,0.191330692
20200504,VI,66,965,4,C,1031,14,0,14,0
20200504,VT,906,15889,52,C,16795,319,5,324,0.015432099
20200504,WA,16262,215091,834,B,231353,6182,374,6556,0.05704698
20200504,WI,8236,80467,340,A,88703,2470,272,2742,0.099197666
20200504,WV,1206,52033,50,C,53239,1586,15,1601,0.009369144
20200504,WY,586,9868,7,C,10454,228,7,235,0.029787234
20200503,AK,368,21210,9,C,21578,176,3,179,0.016759777
20200503,AL,7725,84775,290,B,92500,0,291,291,1
20200503,AR,3431,49459,76,B,52890,1249,59,1308,0.045107034
20200503,AS,0,57,0,F,57,0,0,0,0
20200503,AZ,8640,72479,362,A+,81119,2846,276,3122,0.088404869
20200503,CA,53616,662135,2215,B,715751,27529,1419,28948,0.04901893
20200503,CO,16225,63681,832,B,79906,2500,457,2957,0.154548529
20200503,CT,29287,73206,2436,B,102493,1713,523,2236,0.233899821
20200503,DC,5016,18086,251,B,23102,879,219,1098,0.199453552
20200503,DE,5208,18529,177,B,23737,455,170,625,0.272
20200503,FL,36078,392111,1403,C,428189,11562,615,12177,0.050505051
20200503,GA,28602,146494,1177,A,175096,0,296,296,1
20200503,GU,150,3152,5,F,3302,112,2,114,0.01754386
20200503,HI,620,32330,16,B,32950,964,1,965,0.001036269
20200503,IA,9169,44017,184,B,53186,6309,528,6837,0.077226854
20200503,ID,2061,27746,63,C,29807,291,26,317,0.082018927
20200503,IL,61499,257814,2618,A,319313,16423,2994,19417,0.154194778
20200503,IN,19933,88926,1246,A+,108859,4080,638,4718,0.135226791
20200503,KS,5030,31748,134,A,36778,1552,284,1836,0.154684096
20200503,KY,4879,52770,248,A,57649,0,0,0,0
20200503,LA,29340,146820,1969,B,176160,3102,200,3302,0.060569352
20200503,MA,68087,246559,4004,A,314646,13828,1824,15652,0.116534628
20200503,MD,25462,107332,1281,A,132794,6283,989,7272,0.1360011
20200503,ME,1185,19546,57,B,20731,0,33,33,1
20200503,MI,43754,168778,4049,A+,212532,10276,547,10823,0.050540516
20200503,MN,6663,75969,419,A,82632,3190,435,3625,0.12
20200503,MO,8386,74590,352,A,82976,0,232,232,1
20200503,MP,14,1321,2,D,1335,387,0,387,0
20200503,MS,7550,70043,303,B,77593,3009,109,3118,0.034958307
20200503,MT,455,14552,16,C,15007,372,0,372,0
20200503,NC,11664,132171,422,B,143835,4205,155,4360,0.035550459
20200503,ND,1191,32162,25,C,33353,1768,38,1806,0.021040975
20200503,NE,5326,25936,76,D,31262,1426,488,1914,0.254963427
20200503,NH,2429,25964,84,C,28393,3925,119,4044,0.029426311
20200503,NJ,126744,148322,7871,A+,275066,9727,3027,12754,0.237337306
20200503,NM,3732,71212,139,C,74944,3607,219,3826,0.057239937
20200503,NV,5426,39843,257,D,45269,767,115,882,0.130385488
20200503,NY,316415,669496,19189,B,985911,23402,3438,26840,0.128092399
20200503,OH,19914,130252,1038,B,150166,3768,579,4347,0.133195307
20200503,OK,3972,59804,238,A,63776,0,121,121,1
20200503,OR,2680,59374,109,A+,62054,1873,45,1918,0.02346194
20200503,PA,49267,191374,2444,B,240641,4303,962,5265,0.182716049
20200503,PR,1808,9313,97,D,11121,0,51,51,1
20200503,RI,9477,62450,320,A+,71927,1811,188,1999,0.094047024
20200503,SC,6626,57562,275,B,64188,2435,137,2572,0.053265941
20200503,SD,2631,15786,21,C,18417,283,43,326,0.13190184
20200503,TN,13177,191430,210,B,204607,7815,516,8331,0.061937342
20200503,TX,31548,359012,867,B,390560,8886,1026,9912,0.103510896
20200503,UT,5175,116927,50,C,122102,4104,194,4298,0.045137273
20200503,VA,18671,89331,660,B,108002,4966,940,5906,0.159160176
20200503,VI,66,951,4,C,1017,29,0,29,0
20200503,VT,901,15570,52,C,16471,338,5,343,0.014577259
20200503,WA,15888,208909,830,B,224797,1289,78,1367,0.057059254
20200503,WI,7964,77997,339,A+,85961,2427,304,2731,0.111314537
20200503,WV,1191,50447,50,C,51638,2470,22,2492,0.00882825
20200503,WY,579,9640,7,C,10219,177,13,190,0.068421053
20200502,AK,365,21034,9,C,21399,1073,1,1074,0.000931099
20200502,AL,7434,84775,288,B,92209,0,276,276,1
20200502,AR,3372,48210,73,B,51582,1855,51,1906,0.026757608
20200502,AS,0,57,0,F,57,0,0,0,0
20200502,AZ,8364,69633,348,A+,77997,2716,402,3118,0.128928801
20200502,CA,52197,634606,2171,B,686803,30063,1755,31818,0.055157458
20200502,CO,15768,61181,820,B,76949,4075,484,4559,0.106163632
20200502,CT,28764,71493,2339,B,100257,0,0,0,0
20200502,DC,4797,17207,240,B,22004,730,139,869,0.15995397
20200502,DE,5038,18074,168,B,23112,407,120,527,0.227703985
20200502,FL,35463,380549,1388,C,416012,12578,735,13313,0.055209194
20200502,GA,28306,146494,1174,A,174800,5397,1036,6433,0.161044614
20200502,GU,148,3040,5,F,3188,181,2,183,0.010928962
20200502,HI,619,31366,16,B,31985,890,1,891,0.001122334
20200502,IA,8641,37708,175,A,46349,0,757,757,1
20200502,ID,2035,27455,63,C,29490,245,20,265,0.075471698
20200502,IL,58505,241391,2559,A,299896,12758,2450,15208,0.161099421
20200502,IN,19295,84846,1229,A+,104141,3837,665,4502,0.147712128
20200502,KS,4746,30196,131,A,34942,1611,297,1908,0.155660377
20200502,KY,4879,52770,248,A,57649,866,171,1037,0.164898746
20200502,LA,29140,143718,1950,B,172858,4178,429,4607,0.093119166
20200502,MA,66263,232731,3846,A,298994,7406,1952,9358,0.208591579
20200502,MD,24473,101049,1251,A,125522,3538,1001,4539,0.220533157
20200502,ME,1152,19546,56,B,20698,0,29,29,1
20200502,MI,43207,158502,4020,A+,201709,10353,851,11204,0.075955016
20200502,MN,6228,72779,395,A,79007,3680,498,4178,0.119195787
20200502,MO,8154,74590,351,A,82744,0,319,319,1
20200502,MP,14,934,2,D,948,185,0,185,0
20200502,MS,7441,67034,291,B,74475,2698,229,2927,0.078237103
20200502,MT,455,14180,16,C,14635,430,2,432,0.00462963
20200502,NC,11509,127966,420,B,139475,5057,586,5643,0.103845472
20200502,ND,1153,30394,24,C,31547,1976,46,2022,0.022749753
20200502,NE,4838,24510,73,D,29348,1406,557,1963,0.283749363
20200502,NH,2310,22039,81,C,24349,2136,164,2300,0.071304348
20200502,NJ,123717,138595,7742,A+,262312,3240,2527,5767,0.438182764
20200502,NM,3513,67605,131,C,71118,3147,102,3249,0.031394275
20200502,NV,5311,39076,254,D,44387,708,84,792,0.106060606
20200502,NY,312977,646094,18909,B,959071,26970,4663,31633,0.147409351
20200502,OH,19335,126484,1021,B,145819,4721,592,5313,0.111424807
20200502,OK,3851,59804,238,A,63655,0,103,103,1
20200502,OR,2635,57501,109,A,60136,1904,56,1960,0.028571429
20200502,PA,48305,187071,2418,B,235376,6594,1334,7928,0.168264379
20200502,PR,1757,9313,95,D,11070,0,182,182,1
20200502,RI,9289,60639,296,A+,69928,2953,327,3280,0.099695122
20200502,SC,6489,55127,267,B,61616,2006,231,2237,0.103263299
20200502,SD,2588,15503,21,C,18091,665,63,728,0.086538462
20200502,TN,12661,183615,209,B,196276,9374,770,10144,0.07590694
20200502,TX,30522,350126,847,B,380648,27580,1293,28873,0.044782323
20200502,UT,4981,112823,49,C,117804,5093,153,5246,0.029165078
20200502,VA,17731,84365,616,B,102096,-5174,830,-4344,-0.19106814
20200502,VI,66,922,4,C,988,111,0,111,0
20200502,VT,896,15232,51,C,16128,302,11,313,0.03514377
20200502,WA,15810,207620,824,B,223430,2446,106,2552,0.04153605
20200502,WI,7660,75570,334,A+,83230,3004,346,3350,0.103283582
20200502,WV,1169,47977,48,C,49146,2269,33,2302,0.014335361
20200502,WY,566,9463,7,C,10029,327,7,334,0.020958084
20200501,AK,364,19961,9,C,20325,1197,9,1206,0.007462687
20200501,AL,7158,84775,279,B,91933,4598,139,4737,0.029343466
20200501,AR,3321,46355,64,B,49676,1231,66,1297,0.050886662
20200501,AS,0,57,0,F,57,54,0,54,0
20200501,AZ,7962,66917,330,A+,74879,2779,314,3093,0.10151956
20200501,CA,50442,604543,2073,B,654985,28123,1525,29648,0.051436859
20200501,CO,15284,57106,777,B,72390,805,526,1331,0.395191585
20200501,CT,28764,71493,2339,B,100257,2060,1064,3124,0.340588988
20200501,DC,4658,16477,231,B,21135,721,335,1056,0.317234848
20200501,DE,4918,17667,159,B,22585,581,184,765,0.240522876
20200501,FL,34728,367971,1314,C,402699,19256,1038,20294,0.051148123
20200501,GA,27270,141097,1154,A,168367,18208,1115,19323,0.057703255
20200501,GU,146,2859,5,F,3005,897,0,897,0
20200501,HI,618,30476,16,B,31094,449,5,454,0.011013216
20200501,IA,7884,37708,170,A,45592,2186,739,2925,0.252649573
20200501,ID,2015,27210,63,C,29225,348,31,379,0.081794195
20200501,IL,56055,228633,2457,A,284688,11684,3137,14821,0.211659132
20200501,IN,18630,81009,1175,A+,99639,3846,795,4641,0.171299289
20200501,KS,4449,28585,130,A,33034,1197,211,1408,0.149857955
20200501,KY,4708,51904,240,A,56612,2342,169,2511,0.067303863
20200501,LA,28711,139540,1927,B,168251,6232,710,6942,0.102276001
20200501,MA,64311,225325,3716,A,289636,11883,2106,13989,0.150546858
20200501,MD,23472,97511,1192,A,120983,4894,1730,6624,0.261171498
20200501,ME,1123,19546,55,B,20669,0,28,28,1
20200501,MI,42356,148149,3866,A+,190505,9261,977,10238,0.095428795
20200501,MN,5730,69099,371,A,74829,3959,594,4553,0.130463431
20200501,MO,7835,74590,337,A,82425,1465,273,1738,0.1570771
20200501,MP,14,749,2,D,763,164,0,164,0
20200501,MS,7212,64336,281,B,71548,4811,397,5208,0.076228879
20200501,MT,453,13750,16,C,14203,289,0,289,0
20200501,NC,10923,122909,399,B,133832,5382,414,5796,0.071428571
20200501,ND,1107,28418,23,C,29525,2025,40,2065,0.01937046
20200501,NE,4281,23104,70,D,27385,1567,497,2064,0.240794574
20200501,NH,2146,19903,72,C,22049,36,92,128,0.71875
20200501,NJ,121190,135355,7538,A+,256545,6089,2538,8627,0.294192651
20200501,NM,3411,64458,123,C,67869,2586,198,2784,0.07112069
20200501,NV,5227,38368,243,D,43595,1380,229,1609,0.142324425
20200501,NY,308314,619124,18610,B,927438,22860,3942,26802,0.147078576
20200501,OH,18743,121763,1002,B,140506,5900,716,6616,0.108222491
20200501,OK,3748,59804,230,A,63552,0,130,130,1
20200501,OR,2579,55597,104,A,58176,2075,69,2144,0.032182836
20200501,PA,46971,180477,2354,B,227448,4875,1208,6083,0.198586224
20200501,PR,1575,9313,92,D,10888,0,36,36,1
20200501,RI,8962,57686,279,A+,66648,2597,341,2938,0.116065351
20200501,SC,6258,53121,256,B,59379,2704,163,2867,0.056853854
20200501,SD,2525,14838,21,C,17363,259,76,335,0.226865672
20200501,TN,11891,174241,204,B,186132,7350,1156,8506,0.135904068
20200501,TX,29229,322546,816,B,351775,20333,1142,21475,0.053178114
20200501,UT,4828,107730,46,C,112558,3901,156,4057,0.038452058
20200501,VA,16901,89539,581,B,106440,13876,1055,14931,0.070658362
20200501,VI,66,811,4,C,877,4,0,4,0
20200501,VT,885,14930,50,C,15815,573,6,579,0.010362694
20200501,WA,15704,205174,814,B,220878,6076,308,6384,0.048245614
20200501,WI,7314,72566,327,A+,79880,3172,460,3632,0.126651982
20200501,WV,1136,45708,46,C,46844,2285,18,2303,0.007815892
20200501,WY,559,9136,7,C,9695,234,15,249,0.060240964
20200430,AK,355,18764,9,C,19119,0,0,0,0
20200430,AL,7019,80177,269,B,87196,6570,177,6747,0.026233882
20200430,AR,3255,45124,61,B,48379,2867,63,2930,0.021501706
20200430,AS,0,3,0,F,3,0,0,0,0
20200430,AZ,7648,64138,320,A+,71786,2527,446,2973,0.150016818
20200430,CA,48917,576420,1982,B,625337,19781,2417,22198,0.108883683
20200430,CO,14758,56301,766,B,71059,1587,23,1610,0.014285714
20200430,CT,27700,69433,2257,C,97133,1382,933,2315,0.403023758
20200430,DC,4323,15756,224,B,20079,633,217,850,0.255294118
20200430,DE,4734,17086,152,B,21820,203,79,282,0.280141844
20200430,FL,33690,348715,1290,C,382405,8420,497,8917,0.055736234
20200430,GA,26155,122889,1120,A,149044,4522,583,5105,0.114201763
20200430,GU,146,1962,5,F,2108,260,1,261,0.003831418
20200430,HI,613,30027,16,B,30640,1018,4,1022,0.003913894
20200430,IA,7145,35522,162,B,42667,1028,302,1330,0.227067669
20200430,ID,1984,26862,60,C,28846,432,32,464,0.068965517
20200430,IL,52918,216949,2355,A,269867,10637,2563,13200,0.194166667
20200430,IN,17835,77163,1114,A+,94998,2795,653,3448,0.189385151
20200430,KS,4238,27388,129,A,31626,1668,500,2168,0.230627306
20200430,KY,4539,49562,235,A,54101,1526,164,1690,0.09704142
20200430,LA,28001,133308,1862,B,161309,4400,341,4741,0.071925754
20200430,MA,62205,213442,3562,A,275647,8089,1940,10029,0.193439027
20200430,MD,21742,92617,1140,A,114359,2537,893,3430,0.260349854
20200430,ME,1095,19546,53,B,20641,0,39,39,1
20200430,MI,41379,138888,3789,A+,180267,6935,980,7915,0.12381554
20200430,MN,5136,65140,343,A,70276,3040,492,3532,0.139297848
20200430,MO,7562,73125,329,A,80687,3391,137,3528,0.0388322
20200430,MP,14,585,2,D,599,375,0,375,0
20200430,MS,6815,59525,261,B,66340,0,246,246,1
20200430,MT,453,13461,16,C,13914,384,2,386,0.005181347
20200430,NC,10509,117527,378,B,128036,9035,561,9596,0.058461859
20200430,ND,1067,26393,19,C,27460,1890,34,1924,0.017671518
20200430,NE,3784,21537,68,D,25321,1280,410,1690,0.24260355
20200430,NH,2054,19867,66,C,21921,1131,44,1175,0.037446809
20200430,NJ,118652,129266,7228,A+,247918,4212,2388,6600,0.361818182
20200430,NM,3213,61872,112,C,65085,3101,239,3340,0.071556886
20200430,NV,4998,36988,237,D,41986,858,100,958,0.104384134
20200430,NY,304372,596264,18321,B,900636,23474,4681,28155,0.166258213
20200430,OH,18027,115863,975,B,133890,4258,724,4982,0.145323163
20200430,OK,3618,59804,222,A,63422,2010,145,2155,0.067285383
20200430,OR,2510,53522,103,A,56032,1496,64,1560,0.041025641
20200430,PA,45763,175602,2292,B,221365,5085,1397,6482,0.215519901
20200430,PR,1539,9313,92,D,10852,0,106,106,1
20200430,RI,8621,55089,266,A+,63710,3171,374,3545,0.105500705
20200430,SC,6095,50417,244,B,56512,2081,214,2295,0.093246187
20200430,SD,2449,14579,17,C,17028,119,76,195,0.38974359
20200430,TN,10735,166891,199,B,177626,8708,369,9077,0.040652198
20200430,TX,28087,302213,782,B,330300,14477,1033,15510,0.066602192
20200430,UT,4672,103829,46,C,108501,2546,177,2723,0.065001836
20200430,VA,15846,75663,552,B,91509,4684,885,5569,0.158915425
20200430,VI,66,807,4,C,873,75,4,79,0.050632911
20200430,VT,879,14357,49,C,15236,202,13,215,0.060465116
20200430,WA,15396,199098,801,B,214494,5913,241,6154,0.039161521
20200430,WI,6854,69394,316,A+,76248,2764,334,3098,0.107811491
20200430,WV,1118,43423,41,C,44541,1447,23,1470,0.015646259
20200430,WY,544,8902,7,C,9446,221,8,229,0.034934498
20200429,AK,355,18764,9,B,19119,2026,4,2030,0.001970443
20200429,AL,6842,73607,245,B,80449,4467,155,4622,0.033535266
20200429,AR,3192,42257,59,B,45449,4697,81,4778,0.0169527
20200429,AS,0,3,0,F,3,0,0,0,0
20200429,AZ,7202,61611,304,A+,68813,1121,254,1375,0.184727273
20200429,CA,46500,556639,1887,B,603139,24062,1469,25531,0.057537895
20200429,CO,14735,54714,760,B,69449,2252,856,3108,0.275418275
20200429,CT,26767,68051,2168,C,94818,1618,455,2073,0.219488664
20200429,DC,4106,15123,205,B,19229,232,112,344,0.325581395
20200429,DE,4655,16883,144,B,21538,278,80,358,0.223463687
20200429,FL,33193,340295,1240,C,373488,6266,347,6613,0.052472403
20200429,GA,25572,118367,1093,A,143939,2962,957,3919,0.244194948
20200429,GU,145,1702,5,D,1847,164,0,164,0
20200429,HI,609,29009,16,B,29618,433,2,435,0.004597701
20200429,IA,6843,34494,148,B,41337,1047,467,1514,0.308454425
20200429,ID,1952,26430,60,C,28382,8295,35,8330,0.004201681
20200429,IL,50355,206312,2215,A,256667,12225,2253,14478,0.155615416
20200429,IN,17182,74368,1065,A,91550,3775,594,4369,0.135957885
20200429,KS,3738,25720,125,A,29458,1121,247,1368,0.180555556
20200429,KY,4375,48036,225,A,52411,3383,229,3612,0.063399779
20200429,LA,27660,128908,1802,B,156568,5086,374,5460,0.068498168
20200429,MA,60265,205353,3405,A,265618,9155,1963,11118,0.176560532
20200429,MD,20849,90080,1078,A,110929,2408,736,3144,0.234096692
20200429,ME,1056,19546,52,B,20602,2762,16,2778,0.005759539
20200429,MI,40399,131953,3670,A+,172352,6410,1137,7547,0.15065589
20200429,MN,4644,62100,319,A,66744,2452,463,2915,0.158833619
20200429,MO,7425,69734,318,A,77159,3534,122,3656,0.033369803
20200429,MP,14,210,2,D,224,159,0,159,0
20200429,MS,6569,59525,250,B,66094,1455,227,1682,0.134958383
20200429,MT,451,13077,16,C,13528,337,0,337,0
20200429,NC,9948,108492,354,B,118440,5308,380,5688,0.066807314
20200429,ND,1033,24503,19,C,25536,1771,42,1813,0.023166023
20200429,NE,3374,20257,55,D,23631,10,16,26,0.615384615
20200429,NH,2010,18736,60,C,20746,529,72,601,0.119800333
20200429,NJ,116264,125054,6770,A+,241318,4551,2408,6959,0.346026728
20200429,NM,2974,58771,110,C,61745,2791,151,2942,0.051325629
20200429,NV,4898,36130,230,D,41028,816,93,909,0.102310231
20200429,NY,299691,572790,18015,B,872481,22902,4585,27487,0.166806127
20200429,OH,17303,111605,937,B,128908,5027,1175,6202,0.189455015
20200429,OK,3473,57794,214,A,61267,1505,63,1568,0.040178571
20200429,OR,2446,52026,101,A,54472,3182,92,3274,0.028100183
20200429,PA,44366,170517,2195,B,214883,4693,1102,5795,0.190163934
20200429,PR,1433,9313,86,D,10746,0,33,33,1
20200429,RI,8247,51918,251,A+,60165,2151,321,2472,0.129854369
20200429,SC,5881,48336,203,B,54217,1804,268,2072,0.129343629
20200429,SD,2373,14460,13,C,16833,161,60,221,0.271493213
20200429,TN,10366,158183,195,B,168549,6307,314,6621,0.04742486
20200429,TX,27054,287736,732,B,314790,13523,883,14406,0.061293905
20200429,UT,4495,101283,45,C,105778,3187,152,3339,0.045522612
20200429,VA,14961,70979,522,B,85940,2020,622,2642,0.235427706
20200429,VI,62,732,4,C,794,13,3,16,0.1875
20200429,VT,866,14155,47,C,15021,208,4,212,0.018867925
20200429,WA,15155,193185,786,B,208340,6246,318,6564,0.048446069
20200429,WI,6520,66630,308,A,73150,3095,231,3326,0.069452796
20200429,WV,1095,41976,38,C,43071,0,16,16,1
20200429,WY,536,8681,7,C,9217,455,147,602,0.244186047
20200428,AK,351,16738,9,B,17089,827,6,833,0.007202881
20200428,AL,6687,69140,242,B,75827,1642,188,1830,0.10273224
20200428,AR,3111,37560,52,B,40671,120,94,214,0.439252336
20200428,AS,0,3,0,F,3,0,0,0,0
20200428,AZ,6948,60490,293,A+,67438,663,232,895,0.259217877
20200428,CA,45031,532577,1809,B,577608,22632,1567,24199,0.064754742
20200428,CO,13879,52462,706,B,66341,2629,438,3067,0.142810564
20200428,CT,26312,66433,2089,C,92745,11891,1043,12934,0.080640173
20200428,DC,3994,14891,190,B,18885,367,102,469,0.217484009
20200428,DE,4575,16605,137,B,21180,1151,413,1564,0.264066496
20200428,FL,32846,334029,1154,C,366875,9704,708,10412,0.067998463
20200428,GA,24615,115405,1026,B,140020,12149,702,12851,0.054626099
20200428,GU,145,1538,5,D,1683,114,1,115,0.008695652
20200428,HI,607,28576,16,C,29183,172,1,173,0.005780347
20200428,IA,6376,33447,136,B,39823,1165,508,1673,0.303646145
20200428,ID,1917,18135,58,C,20052,8,20,28,0.714285714
20200428,IL,48102,194087,2125,A,242189,12342,2219,14561,0.15239338
20200428,IN,16588,70593,901,B,87181,2078,627,2705,0.231792976
20200428,KS,3491,24599,124,C,28090,760,163,923,0.17659805
20200428,KY,4146,44653,213,A,48799,253,72,325,0.221538462
20200428,LA,27286,123822,1758,B,151108,3901,218,4119,0.052925467
20200428,MA,58302,196198,3153,B,254500,7773,1840,9613,0.191407469
20200428,MD,20113,87672,1016,A,107785,2183,626,2809,0.222855109
20200428,ME,1040,16784,51,B,17824,0,17,17,1
20200428,MI,39262,125543,3567,A+,164805,5993,1052,7045,0.149325763
20200428,MN,4181,59648,301,A,63829,2196,365,2561,0.142522452
20200428,MO,7303,66200,314,B,73503,2265,132,2397,0.055068836
20200428,MP,14,51,2,D,65,0,0,0,0
20200428,MS,6342,58070,239,B,64412,702,248,950,0.261052632
20200428,MT,451,12740,15,C,13191,156,2,158,0.012658228
20200428,NC,9568,103184,342,B,112752,2406,426,2832,0.150423729
20200428,ND,991,22732,19,C,23723,1240,49,1289,0.038013964
20200428,NE,3358,20247,55,D,23605,912,330,1242,0.265700483
20200428,NH,1938,18207,60,C,20145,347,74,421,0.175771971
20200428,NJ,113856,120503,6442,A+,234359,3916,2668,6584,0.405224787
20200428,NM,2823,55980,104,C,58803,2091,97,2188,0.044332724
20200428,NV,4805,35314,219,F,40119,1191,115,1306,0.08805513
20200428,NY,295106,549888,17638,B,844994,15789,3110,18899,0.164558971
20200428,OH,16128,106578,799,B,122706,2886,429,3315,0.129411765
20200428,OK,3410,56289,207,A,59699,6398,130,6528,0.019914216
20200428,OR,2354,48844,92,B,51198,0,0,0,0
20200428,PA,43264,165824,1716,B,209088,4452,1214,5666,0.214260501
20200428,PR,1400,9313,86,D,10713,0,11,11,1
20200428,RI,7926,49767,239,A+,57693,1590,218,1808,0.120575221
20200428,SC,5613,46532,177,B,52145,1261,123,1384,0.088872832
20200428,SD,2313,14299,11,C,16612,169,68,237,0.286919831
20200428,TN,10052,151876,188,B,161928,7392,134,7526,0.017804943
20200428,TX,26171,274213,690,B,300384,8993,874,9867,0.088578089
20200428,UT,4343,98096,45,C,102439,2134,110,2244,0.049019608
20200428,VA,14339,68959,492,B,83298,1815,804,2619,0.3069874
20200428,VI,59,719,4,D,778,3,0,3,0
20200428,VT,862,13947,47,C,14809,128,0,128,0
20200428,WA,14837,186939,765,B,201776,6463,280,6743,0.041524544
20200428,WI,6289,63535,300,A,69824,2224,208,2432,0.085526316
20200428,WV,1079,41976,37,B,43055,0,16,16,1
20200428,WY,389,8226,7,C,8615,429,19,448,0.042410714
20200427,AK,345,15911,9,B,16256,75,4,79,0.050632911
20200427,AL,6499,67498,222,B,73997,217,229,446,0.513452915
20200427,AR,3017,37440,50,B,40457,912,76,988,0.076923077
20200427,AS,0,3,0,F,3,0,0,0,0
20200427,AZ,6716,59827,275,A+,66543,1542,190,1732,0.109699769
20200427,CA,43464,509945,1755,B,553409,26025,1300,27325,0.04757548
20200427,CO,13441,49833,680,B,63274,3010,473,3483,0.135802469
20200427,CT,25269,54542,1998,C,79811,0,0,0,0
20200427,DC,3892,14524,185,B,18416,297,51,348,0.146551724
20200427,DE,4162,15454,125,B,19616,239,128,367,0.348773842
20200427,FL,32138,324325,1101,C,356463,11240,610,11850,0.051476793
20200427,GA,23913,103256,971,B,127169,3434,512,3946,0.129751647
20200427,GU,144,1424,5,D,1568,37,3,40,0.075
20200427,HI,606,28404,14,C,29010,524,3,527,0.0056926
20200427,IA,5868,32282,127,B,38150,1668,392,2060,0.190291262
20200427,ID,1897,18127,56,C,20024,516,10,526,0.019011407
20200427,IL,45883,181745,1983,A,227628,10696,1980,12676,0.156200694
20200427,IN,15961,68515,844,B,84476,1819,949,2768,0.342846821
20200427,KS,3328,23839,120,C,27167,786,154,940,0.163829787
20200427,KY,4074,44400,208,A,48474,1747,169,1916,0.088204593
20200427,LA,27068,119921,1697,B,146989,3658,295,3953,0.074626866
20200427,MA,56462,188425,3003,B,244887,7263,1524,8787,0.173438033
20200427,MD,19487,85489,945,A,104976,7405,906,8311,0.109012153
20200427,ME,1023,16784,51,B,17807,0,8,8,1
20200427,MI,38210,119550,3407,A+,157760,6322,432,6754,0.063962097
20200427,MN,3816,57452,286,A,61268,2067,214,2281,0.093818501
20200427,MO,7171,63935,288,B,71106,1184,174,1358,0.128129602
20200427,MP,14,51,2,D,65,0,0,0,0
20200427,MS,6094,57368,229,B,63462,2491,183,2674,0.068436799
20200427,MT,449,12584,14,C,13033,170,1,171,0.005847953
20200427,NC,9142,100778,306,B,109920,1714,312,2026,0.153998026
20200427,ND,942,21492,19,C,22434,1642,75,1717,0.043680839
20200427,NE,3028,19335,56,D,22363,839,296,1135,0.260792952
20200427,NH,1864,17860,60,C,19724,896,77,973,0.079136691
20200427,NJ,111188,116587,6044,A,227775,2481,2150,4631,0.464262578
20200427,NM,2726,53889,99,C,56615,2814,66,2880,0.022916667
20200427,NV,4690,34123,206,F,38813,539,88,627,0.140350877
20200427,NY,291996,534099,17303,B,826095,16794,3951,20745,0.190455531
20200427,OH,15699,103692,753,B,119391,3269,-264,3005,-0.087853577
20200427,OK,3280,49891,197,A,53171,0,27,27,1
20200427,OR,2354,48844,92,B,51198,2191,43,2234,0.019247986
20200427,PA,42050,161372,1597,B,203422,3944,885,4829,0.183267757
20200427,PR,1389,9313,84,D,10702,0,18,18,1
20200427,RI,7708,48177,233,A+,55885,2213,269,2482,0.108380338
20200427,SC,5490,45271,174,B,50761,0,0,0,0
20200427,SD,2245,14130,11,C,16375,68,33,101,0.326732673
20200427,TN,9918,144484,184,B,154402,6677,251,6928,0.036229792
20200427,TX,25297,265220,663,B,290517,13830,666,14496,0.045943709
20200427,UT,4233,95962,41,C,100195,4383,110,4493,0.024482528
20200427,VA,13535,67144,458,B,80679,3514,565,4079,0.138514342
20200427,VI,59,716,4,D,775,16,2,18,0.111111111
20200427,VT,862,13819,47,C,14681,301,7,308,0.022727273
20200427,WA,14557,180476,749,B,195033,6600,353,6953,0.050769452
20200427,WI,6081,61311,281,A,67392,2076,170,2246,0.075690116
20200427,WV,1063,41976,36,B,43039,3957,19,3976,0.004778672
20200427,WY,370,7797,7,C,8167,0,8,8,1
20200426,AK,341,15836,9,B,16177,443,2,445,0.004494382
20200426,AL,6270,67281,216,B,73551,2074,133,2207,0.0602628
20200426,AR,2941,36528,49,B,39469,1304,112,1416,0.079096045
20200426,AS,0,3,0,F,3,0,0,0,0
20200426,AZ,6526,58285,275,A+,64811,2057,246,2303,0.106817195
20200426,CA,42164,483920,1710,B,526084,19022,1027,20049,0.0512245
20200426,CO,12968,46823,672,B,59791,2290,712,3002,0.237175217
20200426,CT,25269,54542,1924,C,79811,1522,687,2209,0.311000453
20200426,DC,3841,14227,178,B,18068,624,142,766,0.18537859
20200426,DE,4034,15215,120,B,19249,1093,458,1551,0.295293359
20200426,FL,31528,313085,1094,C,344613,10825,689,11514,0.059840195
20200426,GA,23401,99822,912,B,123223,3503,706,4209,0.167735804
20200426,GU,141,1387,5,D,1528,79,0,79,0
20200426,HI,603,27880,14,C,28483,441,2,443,0.004514673
20200426,IA,5476,30614,118,B,36090,1356,384,1740,0.220689655
20200426,ID,1887,17611,56,C,19498,0,17,17,1
20200426,IL,43903,171049,1933,A,214952,11209,2126,13335,0.159430071
20200426,IN,15012,66696,813,B,81708,1317,617,1934,0.319027921
20200426,KS,3174,23053,118,C,26227,910,118,1028,0.114785992
20200426,KY,3905,42653,205,A,46558,1470,126,1596,0.078947368
20200426,LA,26773,116263,1670,B,143036,3773,261,4034,0.06470005
20200426,MA,54938,181162,2899,B,236100,7665,1590,9255,0.171799028
20200426,MD,18581,78084,910,A,96665,6727,815,7542,0.108061522
20200426,ME,1015,16784,50,B,17799,0,25,25,1
20200426,MI,37778,113228,3315,A+,151006,6387,575,6962,0.082591209
20200426,MN,3602,55385,272,A,58987,2234,156,2390,0.065271967
20200426,MO,6997,62751,274,B,69748,2359,171,2530,0.067588933
20200426,MP,14,51,2,D,65,0,0,0,0
20200426,MS,5911,54877,227,B,60788,1638,193,1831,0.105406881
20200426,MT,448,12414,14,C,12862,362,3,365,0.008219178
20200426,NC,8830,99064,299,B,107894,2422,207,2629,0.078737162
20200426,ND,867,19850,17,C,20717,1303,64,1367,0.046817849
20200426,NE,2732,18496,53,D,21228,944,311,1255,0.247808765
20200426,NH,1787,16964,60,C,18751,957,67,1024,0.065429688
20200426,NJ,109038,114106,5938,A,223144,5943,3515,9458,0.371643053
20200426,NM,2660,51075,93,C,53735,2086,139,2225,0.06247191
20200426,NV,4602,33584,206,F,38186,915,63,978,0.064417178
20200426,NY,288045,517305,16966,B,805350,21880,5902,27782,0.212439709
20200426,OH,15963,100423,728,B,116386,4027,376,4403,0.085396321
20200426,OK,3253,49891,195,A,53144,0,60,60,1
20200426,OR,2311,46653,91,B,48964,1529,58,1587,0.036546944
20200426,PA,41165,157428,1550,B,198593,4542,1116,5658,0.197242842
20200426,PR,1371,9313,84,D,10684,0,64,64,1
20200426,RI,7439,45964,226,A+,53403,2202,310,2512,0.123407643
20200426,SC,5490,45271,174,B,50761,1510,237,1747,0.135661133
20200426,SD,2212,14062,11,C,16274,613,65,678,0.095870206
20200426,TN,9667,137807,181,B,147474,5590,478,6068,0.078773896
20200426,TX,24631,251390,648,B,276021,12347,858,13205,0.064975388
20200426,UT,4123,91579,41,C,95702,5321,175,5496,0.031841339
20200426,VA,12970,63630,448,B,76600,3354,604,3958,0.152602324
20200426,VI,57,700,4,D,757,7,2,9,0.222222222
20200426,VT,855,13518,46,C,14373,248,3,251,0.011952191
20200426,WA,14204,173876,738,B,188080,1586,106,1692,0.062647754
20200426,WI,5911,59235,272,A,65146,2097,224,2321,0.096510125
20200426,WV,1044,38019,34,B,39063,6073,24,6097,0.003936362
20200426,WY,362,7797,7,C,8159,0,13,13,1
20200425,AK,339,15393,9,B,15732,3451,0,3451,0
20200425,AL,6137,65207,212,B,71344,18344,305,18649,0.016354764
20200425,AR,2829,35224,47,B,38053,2387,88,2475,0.035555556
20200425,AS,0,3,0,F,3,0,0,0,0
20200425,AZ,6280,56228,266,A+,62508,1559,235,1794,0.130992196
20200425,CA,41137,464898,1651,B,506035,9979,1883,11862,0.158742202
20200425,CO,12256,44533,674,B,56789,3471,994,4465,0.222620381
20200425,CT,24582,53020,1862,C,77602,2903,661,3564,0.185465769
20200425,DC,3699,13603,165,B,17302,598,171,769,0.22236671
20200425,DE,3576,14122,112,B,17698,185,134,319,0.420062696
20200425,FL,30839,302260,1075,C,333099,15475,665,16140,0.041201983
20200425,GA,22695,96319,904,B,119014,11290,548,11838,0.046291603
20200425,GU,141,1308,5,D,1449,75,0,75,0
20200425,HI,601,27439,13,C,28040,1148,5,1153,0.004336513
20200425,IA,5092,29258,112,B,34350,1730,647,2377,0.272191838
20200425,ID,1870,17611,54,C,19481,0,34,34,1
20200425,IL,41777,159840,1874,A,201617,9866,2119,11985,0.176804339
20200425,IN,14395,65379,785,B,79774,3506,715,4221,0.16939114
20200425,KS,3056,22143,117,C,25199,1332,279,1611,0.173184358
20200425,KY,3779,41183,200,A,44962,1820,298,2118,0.140698772
20200425,LA,26512,112490,1644,B,139002,518,372,890,0.417977528
20200425,MA,53348,173497,2877,B,226845,9253,2379,11632,0.204522008
20200425,MD,17766,71357,875,A,89123,3257,1150,4407,0.260948491
20200425,ME,990,16784,50,B,17774,0,25,25,1
20200425,MI,37203,106841,3274,A+,144044,7186,562,7748,0.072534848
20200425,MN,3446,53151,244,A,56597,2549,261,2810,0.092882562
20200425,MO,6826,60392,273,B,67218,1810,201,2011,0.099950273
20200425,MP,14,51,2,D,65,0,0,0,0
20200425,MS,5718,53239,221,B,58957,3003,284,3287,0.086400974
20200425,MT,445,12052,14,C,12497,369,1,370,0.002702703
20200425,NC,8623,96642,289,B,105265,4110,571,4681,0.121982482
20200425,ND,803,18547,16,C,19350,1846,55,1901,0.028932141
20200425,NE,2421,17552,50,D,19973,1064,297,1361,0.218221896
20200425,NH,1720,16007,53,C,17727,868,50,918,0.054466231
20200425,NJ,105523,108163,5863,A,213686,4397,3327,7724,0.43073537
20200425,NM,2521,48989,84,C,51510,4805,142,4947,0.028704265
20200425,NV,4539,32669,204,F,37208,875,141,1016,0.138779528
20200425,NY,282143,495425,16599,B,777568,36359,10553,46912,0.224953104
20200425,OH,15587,96396,711,B,111983,3868,418,4286,0.097526832
20200425,OK,3193,49891,194,A,53084,6872,72,6944,0.010368664
20200425,OR,2253,45124,87,B,47377,1809,76,1885,0.040318302
20200425,PA,40049,152886,1537,B,192935,5395,1397,6792,0.205683157
20200425,PR,1307,9313,83,D,10620,0,31,31,1
20200425,RI,7129,43762,215,A+,50891,3204,430,3634,0.118326912
20200425,SC,5253,43761,166,B,49014,4215,336,4551,0.073829927
20200425,SD,2147,13449,10,C,15596,665,107,772,0.138601036
20200425,TN,9189,132217,178,B,141406,9615,463,10078,0.045941655
20200425,TX,23773,239043,623,B,262816,19302,967,20269,0.047708323
20200425,UT,3948,86258,41,C,90206,5343,166,5509,0.03013251
20200425,VA,12366,60276,436,B,72642,2430,772,3202,0.241099313
20200425,VI,55,693,3,D,748,51,1,52,0.019230769
20200425,VT,852,13270,46,C,14122,462,9,471,0.01910828
20200425,WA,14098,172290,665,B,186388,3194,165,3359,0.049121762
20200425,WI,5687,57138,266,A,62825,2565,331,2896,0.11429558
20200425,WV,1020,31946,32,B,32966,3123,32,3155,0.010142631
20200425,WY,349,7797,7,C,8146,101,0,101,0
20200424,AK,339,11942,9,A,12281,118,2,120,0.016666667
20200424,AL,5832,46863,197,B,52695,0,54,54,1
20200424,AR,2741,32837,45,A,35578,3712,276,3988,0.069207623
20200424,AS,0,3,0,0,3,0,0,0,0
20200424,AZ,6045,54669,266,B,60714,1741,276,2017,0.136836886
20200424,CA,39254,454919,1562,B,494173,10191,1885,12076,0.156094733
20200424,CO,11262,41062,552,A,52324,1295,384,1679,0.228707564
20200424,CT,23921,50117,1764,A,74038,1720,821,2541,0.323101141
20200424,DC,3528,13005,153,A,16533,436,167,603,0.27694859
20200424,DE,3442,13937,100,A,17379,333,134,467,0.286937901
20200424,FL,30174,286785,1031,A,316959,18909,1342,20251,0.066268332
20200424,GA,22147,85029,892,A,107176,5479,635,6114,0.103859993
20200424,GU,141,1233,5,0,1374,53,6,59,0.101694915
20200424,HI,596,26291,12,A,26887,755,4,759,0.005270092
20200424,IA,4445,27528,107,A,31973,2190,521,2711,0.192180007
20200424,ID,1836,17611,54,A,19447,241,34,275,0.123636364
20200424,IL,39658,149974,1795,A,189632,13592,2724,16316,0.166952684
20200424,IN,13680,61873,741,B,75553,2872,641,3513,0.18246513
20200424,KS,2777,20811,111,B,23588,1975,295,2270,0.129955947
20200424,KY,3481,39363,191,A,42844,6661,108,6769,0.015955089
20200424,LA,26140,111972,1601,A,138112,198,401,599,0.669449082
20200424,MA,50969,164244,2877,B,215213,7920,2977,10897,0.273194457
20200424,MD,16616,68100,798,A,84716,3737,879,4616,0.19042461
20200424,ME,965,16784,47,A,17749,0,28,28,1
20200424,MI,36641,99655,3085,B,136296,6625,1350,7975,0.169278997
20200424,MN,3185,50602,221,A,53787,1996,243,2239,0.108530594
20200424,MO,6625,58582,262,A,65207,5453,304,5757,0.052805281
20200424,MP,14,51,2,0,65,0,0,0,0
20200424,MS,5434,50236,209,A,55670,0,281,281,1
20200424,MT,444,11683,14,A,12127,250,2,252,0.007936508
20200424,NC,8052,92532,269,A,100584,3955,444,4399,0.10093203
20200424,ND,748,16701,15,B,17449,1080,39,1119,0.034852547
20200424,NE,2124,16488,47,A,18612,941,311,1252,0.248402556
20200424,NH,1670,15139,51,B,16809,715,82,797,0.102885822
20200424,NJ,102196,103766,5617,A,205962,3607,2207,5814,0.379600963
20200424,NM,2379,44184,78,A,46563,5162,169,5331,0.031701369
20200424,NV,4398,31794,197,A,36192,1253,190,1443,0.131670132
20200424,NY,271590,459066,16162,A,730656,26606,8130,34736,0.234051129
20200424,OH,15169,92528,690,B,107697,4345,475,4820,0.098547718
20200424,OK,3121,43019,188,B,46140,0,104,104,1
20200424,OR,2177,43315,86,A,45492,1466,50,1516,0.03298153
20200424,PA,38652,147491,1492,A,186143,5430,1599,7029,0.227486129
20200424,PR,1276,9313,77,A,10589,0,361,361,1
20200424,RI,6699,40558,202,B,47257,2395,437,2832,0.15430791
20200424,SC,4917,39546,150,B,44463,0,0,0,0
20200424,SD,2040,12784,10,A,14824,675,84,759,0.110671937
20200424,TN,8726,122602,168,A,131328,7768,460,8228,0.05590666
20200424,TX,22806,219741,593,A,242547,16607,862,17469,0.049344553
20200424,UT,3782,80915,39,A,84697,3900,170,4070,0.041769042
20200424,VA,11594,57846,410,A,69440,3955,596,4551,0.130960229
20200424,VI,54,642,3,0,696,59,0,59,0
20200424,VT,843,12808,44,A,13651,388,9,397,0.022670025
20200424,WA,13933,169096,659,C,183029,6498,344,6842,0.050277697
20200424,WI,5356,54573,262,A,59929,3117,304,3421,0.088862906
20200424,WV,988,28823,32,B,29811,1885,21,1906,0.011017838
20200424,WY,349,7696,7,A,8045,455,23,478,0.048117155
20200423,AK,337,11824,9,A,12161,0,2,2,1
20200423,AL,5778,46863,197,B,52641,3568,313,3881,0.080649317
20200423,AR,2465,29125,45,A,31590,1688,189,1877,0.100692595
20200423,AS,0,3,0,0,3,0,0,0,0
20200423,AZ,5769,52928,249,B,58697,1786,310,2096,0.147900763
20200423,CA,37369,444728,1469,B,482097,14797,1973,16770,0.117650566
20200423,CO,10878,39767,508,A,50645,1510,431,1941,0.222050489
20200423,CT,23100,48397,1639,A,71497,948,631,1579,0.399620013
20200423,DC,3361,12569,139,A,15930,273,155,428,0.362149533
20200423,DE,3308,13604,92,A,16912,251,108,359,0.300835655
20200423,FL,28832,267876,979,A,296708,7558,523,8081,0.064719713
20200423,GA,21512,79550,872,A,101062,6218,772,6990,0.110443491
20200423,GU,135,1180,5,0,1315,94,1,95,0.010526316
20200423,HI,592,25536,12,A,26128,776,10,786,0.012722646
20200423,IA,3924,25338,96,A,29262,842,176,1018,0.172888016
20200423,ID,1802,17370,54,A,19172,966,36,1002,0.035928144
20200423,IL,36934,136382,1688,A,173316,7144,1826,8970,0.203567447
20200423,IN,13039,59001,706,B,72040,1969,601,2570,0.23385214
20200423,KS,2482,18836,112,B,21318,844,271,1115,0.243049327
20200423,KY,3373,32702,185,A,36075,2566,181,2747,0.065890062
20200423,LA,25739,111774,1540,A,137513,186,481,667,0.72113943
20200423,MA,47992,156324,2769,B,204316,11535,3079,14614,0.210688381
20200423,MD,15737,64363,748,A,80100,2609,962,3571,0.269392327
20200423,ME,937,16784,44,A,17721,0,30,30,1
20200423,MI,35291,93030,2977,B,128321,8771,1325,10096,0.131240095
20200423,MN,2942,48606,200,A,51548,1983,221,2204,0.100272232
20200423,MO,6321,53129,218,A,59450,1110,184,1294,0.142194745
20200423,MP,14,51,2,0,65,0,0,0,0
20200423,MS,5153,50236,201,A,55389,1295,259,1554,0.166666667
20200423,MT,442,11433,14,A,11875,289,3,292,0.010273973
20200423,NC,7608,88577,253,A,96185,5461,388,5849,0.066336126
20200423,ND,709,15621,15,B,16330,711,30,741,0.04048583
20200423,NE,1813,15547,45,A,17360,590,91,681,0.133627019
20200423,NH,1588,14424,48,B,16012,874,97,971,0.099897013
20200423,NJ,99989,100159,5368,A,200148,4365,4124,8489,0.48580516
20200423,NM,2210,39022,71,A,41232,217,138,355,0.388732394
20200423,NV,4208,30541,189,A,34749,734,127,861,0.147502904
20200423,NY,263460,432460,15740,A,695920,19694,6244,25938,0.24072789
20200423,OH,14694,88183,656,B,102877,3794,577,4371,0.132006406
20200423,OK,3017,43019,179,B,46036,0,123,123,1
20200423,OR,2127,41849,83,A,43976,2723,68,2791,0.024364027
20200423,PA,37053,142061,1421,A,179114,5789,1369,7158,0.19125454
20200423,PR,915,9313,69,A,10228,471,0,471,0
20200423,RI,6262,38163,213,B,44425,2282,417,2699,0.154501667
20200423,SC,4917,39546,150,B,44463,1196,156,1352,0.115384615
20200423,SD,1956,12109,9,A,14065,521,98,619,0.158319871
20200423,TN,8266,114834,170,A,123100,7696,424,8120,0.052216749
20200423,TX,21944,203134,561,A,225078,7420,875,8295,0.105485232
20200423,UT,3612,77015,35,A,80627,4000,167,4167,0.040076794
20200423,VA,10998,53891,372,A,64889,3379,732,4111,0.178058866
20200423,VI,54,583,3,0,637,0,0,0,0
20200423,VT,834,12420,43,A,13254,323,3,326,0.009202454
20200423,WA,13589,162598,654,C,176187,5160,261,5421,0.048146099
20200423,WI,5052,51456,257,A,56508,1954,207,2161,0.095788987
20200423,WV,967,26938,29,B,27905,2041,28,2069,0.013533108
20200423,WY,326,7241,7,A,7567,-60,4,-56,-0.071428571
20200422,AK,335,11824,9,A,12159,1034,6,1040,0.005769231
20200422,AL,5465,43295,194,B,48760,0,234,234,1
20200422,AR,2276,27437,42,A,29713,2223,49,2272,0.021566901
20200422,AS,0,3,0,0,3,0,0,0,0
20200422,AZ,5459,51142,229,B,56601,1241,208,1449,0.143547274
20200422,CA,35396,429931,1354,B,465327,163092,2135,165227,0.012921617
20200422,CO,10447,38257,486,A,48704,897,341,1238,0.275444265
20200422,CT,22469,47449,1544,A,69918,3617,2109,5726,0.368319944
20200422,DC,3206,12296,127,A,15502,455,108,563,0.191829485
20200422,DE,3200,13353,89,A,16553,418,269,687,0.391557496
20200422,FL,28309,260318,910,A,288627,10754,814,11568,0.070366528
20200422,GA,20740,73332,836,A,94072,5073,859,5932,0.144807822
20200422,GU,134,1086,5,0,1220,53,1,54,0.018518519
20200422,HI,582,24760,12,A,25342,648,-2,646,-0.003095975
20200422,IA,3748,24496,90,A,28244,522,107,629,0.170111288
20200422,ID,1766,16404,51,A,18170,333,30,363,0.082644628
20200422,IL,35108,129238,1565,A,164346,7300,2049,9349,0.219167825
20200422,IN,12438,57032,661,B,69470,1865,341,2206,0.154578422
20200422,KS,2211,17992,110,B,20203,916,186,1102,0.168784029
20200422,KY,3192,30136,171,A,33328,366,142,508,0.279527559
20200422,LA,25258,111588,1473,A,136846,0,404,404,1
20200422,MA,44913,144789,2597,B,189702,3345,1745,5090,0.342829077
20200422,MD,14775,61754,698,A,76529,2312,582,2894,0.201105736
20200422,ME,907,16784,39,A,17691,2708,19,2727,0.006967363
20200422,MI,33966,84259,2813,B,118225,0,999,999,1
20200422,MN,2721,46623,179,A,49344,1493,154,1647,0.093503339
20200422,MO,6137,52019,208,A,58156,840,196,1036,0.189189189
20200422,MP,14,51,2,0,65,0,0,0,0
20200422,MS,4894,48941,193,A,53835,1293,178,1471,0.121006118
20200422,MT,439,11144,14,A,11583,340,2,342,0.005847953
20200422,NC,7220,83116,242,A,90336,6736,269,7005,0.038401142
20200422,ND,679,14910,14,B,15589,567,35,602,0.058139535
20200422,NE,1722,14957,38,A,16679,233,74,307,0.241042345
20200422,NH,1491,13550,42,B,15041,702,0,702,0
20200422,NJ,95865,95794,5063,A,191659,3355,3478,6833,0.509000439
20200422,NM,2072,38805,65,A,40877,2021,101,2122,0.047596607
20200422,NV,4081,29807,172,A,33888,689,144,833,0.172869148
20200422,NY,257216,412766,15302,A,669982,15131,5526,20657,0.267512223
20200422,OH,14117,84389,610,B,98506,3400,392,3792,0.103375527
20200422,OK,2894,43019,170,B,45913,1482,87,1569,0.055449331
20200422,OR,2059,39126,78,A,41185,0,57,57,1
20200422,PA,35684,136272,1622,A,171956,3949,1156,5105,0.226444662
20200422,PR,915,8842,67,A,9757,53,-383,-330,1.160606061
20200422,RI,5845,35881,201,B,41726,2048,378,2426,0.155812036
20200422,SC,4761,38350,140,B,43111,1512,322,1834,0.175572519
20200422,SD,1858,11588,8,A,13446,528,103,631,0.163232964
20200422,TN,7842,107138,166,A,114980,6350,448,6798,0.065901736
20200422,TX,21069,195714,543,A,216783,10511,873,11384,0.076686578
20200422,UT,3445,73015,34,A,76460,3953,149,4102,0.036323745
20200422,VA,10266,50512,349,A,60778,1788,636,2424,0.262376238
20200422,VI,54,583,3,0,637,9,0,9,0
20200422,VT,831,12097,40,A,12928,330,3,333,0.009009009
20200422,WA,13328,157438,647,C,170766,4969,277,5246,0.052802135
20200422,WI,4845,49502,246,A,54347,1661,225,1886,0.119300106
20200422,WV,939,24897,26,B,25836,3048,25,3073,0.008135373
20200422,WY,322,7301,6,A,7623,0,2,2,1
20200421,AK,329,10790,9,A,11119,987,8,995,0.008040201
20200421,AL,5231,43295,177,B,48526,2420,206,2626,0.078446306
20200421,AR,2227,25214,43,A,27441,584,304,888,0.342342342
20200421,AS,0,3,0,0,3,0,0,0,0
20200421,AZ,5251,49901,208,B,55152,465,187,652,0.286809816
20200421,CA,33261,266839,1268,B,300100,7317,2283,9600,0.2378125
20200421,CO,10106,37360,449,A,47466,895,376,1271,0.295830055
20200421,CT,20360,43832,1423,A,64192,841,545,1386,0.393217893
20200421,DC,3098,11841,112,A,14939,655,171,826,0.207021792
20200421,DE,2931,12935,82,A,15866,427,186,613,0.303425775
20200421,FL,27495,249564,856,A,277059,9999,835,10834,0.07707218
20200421,GA,19881,68259,799,A,88140,2878,934,3812,0.24501574
20200421,GU,133,1033,5,0,1166,42,0,42,0
20200421,HI,584,24112,10,A,24696,517,4,521,0.007677543
20200421,IA,3641,23974,83,A,27615,1313,482,1795,0.268523677
20200421,ID,1736,16071,48,A,17807,298,64,362,0.17679558
20200421,IL,33059,121938,1468,A,154997,5088,1551,6639,0.233619521
20200421,IN,12097,55167,630,B,67264,2214,411,2625,0.156571429
20200421,KS,2025,17076,107,B,19101,301,39,340,0.114705882
20200421,KY,3050,29770,154,A,32820,158,90,248,0.362903226
20200421,LA,24854,111588,1405,A,136442,0,331,331,1
20200421,MA,43168,141444,2449,B,184612,5398,1752,7150,0.245034965
20200421,MD,14193,59442,652,A,73635,1729,509,2238,0.22743521
20200421,ME,888,14076,36,A,14964,0,13,13,1
20200421,MI,32967,84259,2700,B,117226,2461,967,3428,0.282088681
20200421,MN,2567,45130,160,A,47697,750,97,847,0.114521842
20200421,MO,5941,51179,189,A,57120,973,134,1107,0.121047877
20200421,MP,14,51,2,0,65,0,0,0,0
20200421,MS,4716,47648,183,A,52364,726,204,930,0.219354839
20200421,MT,437,10804,12,A,11241,186,4,190,0.021052632
20200421,NC,6951,76380,213,A,83331,3660,187,3847,0.048609306
20200421,ND,644,14343,13,B,14987,223,17,240,0.070833333
20200421,NE,1648,14724,33,A,16372,518,174,692,0.251445087
20200421,NH,1491,12848,42,B,14339,122,99,221,0.447963801
20200421,NJ,92387,92439,4753,A,184826,3188,3581,6769,0.529029399
20200421,NM,1971,36784,58,A,38755,1587,126,1713,0.073555166
20200421,NV,3937,29118,163,A,33055,601,107,708,0.151129944
20200421,NY,251690,397635,14828,A,649325,11286,4178,15464,0.270175892
20200421,OH,13725,80989,557,B,94714,3069,806,3875,0.208
20200421,OK,2807,41537,164,B,44344,8571,127,8698,0.014601058
20200421,OR,2002,39126,78,A,41128,1037,46,1083,0.042474608
20200421,PA,34528,132323,1564,A,166851,2603,1296,3899,0.332392921
20200421,PR,1298,8789,64,A,10087,303,46,349,0.131805158
20200421,RI,5467,33833,186,B,39300,1843,369,2212,0.16681736
20200421,SC,4439,36838,124,B,41277,735,62,797,0.077791719
20200421,SD,1755,11060,8,A,12815,419,70,489,0.143149284
20200421,TN,7394,100788,157,A,108182,7337,156,7493,0.020819431
20200421,TX,20196,185203,517,A,205399,14267,738,15005,0.049183605
20200421,UT,3296,69062,32,A,72358,3964,83,4047,0.020509019
20200421,VA,9630,48724,324,A,58354,979,640,1619,0.395305744
20200421,VI,54,574,3,0,628,20,1,21,0.047619048
20200421,VT,828,11767,40,A,12595,96,8,104,0.076923077
20200421,WA,13051,152469,640,C,165520,4806,264,5070,0.052071006
20200421,WI,4620,47841,242,A,52461,1238,121,1359,0.089036056
20200421,WV,914,21849,26,B,22763,596,12,608,0.019736842
20200421,WY,320,7301,6,A,7621,228,7,235,0.029787234
20200420,AK,321,9803,9,A,10124,227,2,229,0.008733624
20200420,AL,5025,40875,167,B,45900,0,188,188,1
20200420,AR,1923,24630,42,A,26553,2202,142,2344,0.060580205
20200420,AS,0,3,0,0,3,0,0,0,0
20200420,AZ,5064,49436,187,B,54500,1375,135,1510,0.089403974
20200420,CA,30978,259522,1208,B,290500,8955,645,9600,0.0671875
20200420,CO,9730,36465,422,A,46195,1292,297,1589,0.186910006
20200420,CT,19815,42991,1331,A,62806,2328,2265,4593,0.493141737
20200420,DC,2927,11186,105,A,14113,280,134,414,0.323671498
20200420,DE,2745,12508,72,A,15253,252,207,459,0.450980392
20200420,FL,26660,239565,806,A,266225,9482,664,10146,0.06544451
20200420,GA,18947,65381,733,A,84328,3749,646,4395,0.14698521
20200420,GU,133,991,5,0,1124,48,0,48,0
20200420,HI,580,23595,10,A,24175,699,6,705,0.008510638
20200420,IA,3159,22661,79,A,25820,1013,257,1270,0.202362205
20200420,ID,1672,15773,45,A,17445,0,4,4,1
20200420,IL,31508,116850,1349,A,148358,3889,1151,5040,0.228373016
20200420,IN,11686,52953,569,B,64639,3021,476,3497,0.136116671
20200420,KS,1986,16775,100,B,18761,494,137,631,0.217115689
20200420,KY,2960,29612,148,A,32572,94,253,347,0.729106628
20200420,LA,24523,111588,1328,A,136111,168,595,763,0.779816514
20200420,MA,41416,136046,2303,B,177462,6751,1596,8347,0.191206421
20200420,MD,13684,57713,582,A,71397,2652,854,3506,0.24358243
20200420,ME,875,14076,35,A,14951,0,8,8,1
20200420,MI,32000,81798,2468,B,113798,3561,576,4137,0.139231327
20200420,MN,2470,44380,143,A,46850,1020,114,1134,0.100529101
20200420,MO,5807,50206,177,A,56013,1964,140,2104,0.066539924
20200420,MP,14,51,2,0,65,9,0,9,0
20200420,MS,4512,46922,169,A,51434,12131,238,12369,0.019241653
20200420,MT,433,10618,10,A,11051,153,0,153,0
20200420,NC,6764,72720,179,A,79484,441,271,712,0.380617978
20200420,ND,627,14120,13,B,14747,1075,42,1117,0.037600716
20200420,NE,1474,14206,28,A,15680,918,187,1105,0.169230769
20200420,NH,1392,12726,41,B,14118,644,50,694,0.07204611
20200420,NJ,88806,89251,4377,A,178057,3864,3505,7369,0.4756412
20200420,NM,1845,35197,55,A,37042,363,47,410,0.114634146
20200420,NV,3830,28517,158,A,32347,647,102,749,0.136181575
20200420,NY,247512,386349,14347,A,633861,11580,4726,16306,0.289831964
20200420,OH,12919,77920,509,B,90839,2223,1317,3540,0.372033898
20200420,OK,2680,32966,143,B,35646,0,81,81,1
20200420,OR,1956,38089,75,A,40045,961,46,1007,0.045680238
20200420,PA,33232,129720,1204,A,162952,3150,948,4098,0.231332357
20200420,PR,1252,8486,63,A,9738,206,39,245,0.159183673
20200420,RI,5098,31990,175,B,37088,1997,343,2340,0.146581197
20200420,SC,4377,36103,120,B,40480,0,0,0,0
20200420,SD,1685,10641,7,A,12326,214,50,264,0.189393939
20200420,TN,7238,93451,152,A,100689,3423,168,3591,0.046783626
20200420,TX,19458,170936,495,A,190394,7149,535,7684,0.069625195
20200420,UT,3213,65098,28,A,68311,4612,144,4756,0.030277544
20200420,VA,8990,47745,300,A,56735,1549,453,2002,0.226273726
20200420,VI,53,554,3,0,607,6,0,6,0
20200420,VT,820,11671,38,A,12491,221,3,224,0.013392857
20200420,WA,12787,147663,629,C,160450,4350,326,4676,0.069717707
20200420,WI,4499,46603,230,A,51102,1280,153,1433,0.106769016
20200420,WV,902,21253,24,B,22155,2085,39,2124,0.018361582
20200420,WY,313,7073,2,A,7386,101,4,105,0.038095238
20200419,AK,319,9576,9,A,9895,235,5,240,0.020833333
20200419,AL,4837,40875,154,B,45712,2992,182,3174,0.057340895
20200419,AR,1781,22428,40,A,24209,26,42,68,0.617647059
20200419,AS,0,3,0,0,3,0,0,0,0
20200419,AZ,4929,48061,184,B,52990,1735,210,1945,0.107969152
20200419,CA,30333,250567,1166,B,280900,19864,1370,21234,0.064519167
20200419,CO,9433,35173,411,A,44606,913,386,1299,0.297151655
20200419,CT,17550,40663,1086,A,58213,2010,741,2751,0.269356598
20200419,DC,2793,10906,96,A,13699,304,127,431,0.294663573
20200419,DE,2538,12256,67,A,14794,562,215,777,0.276705277
20200419,FL,25996,230083,781,A,256079,8825,727,9552,0.076109715
20200419,GA,18301,61632,687,A,79933,5093,632,5725,0.110393013
20200419,GU,133,943,5,0,1076,0,0,0,0
20200419,HI,574,22896,9,A,23470,1106,21,1127,0.01863354
20200419,IA,2902,21648,75,A,24550,1214,389,1603,0.242669994
20200419,ID,1668,15773,44,A,17441,481,13,494,0.026315789
20200419,IL,30357,112961,1290,A,143318,4717,1197,5914,0.202401082
20200419,IN,11210,49932,562,B,61142,3700,569,4269,0.133286484
20200419,KS,1849,16281,92,B,18130,395,59,454,0.129955947
20200419,KY,2707,29518,144,A,32225,1444,185,1629,0.113566605
20200419,LA,23928,111420,1296,A,135348,-2999,348,-2651,-0.131271218
20200419,MA,39820,129295,2146,B,169115,4691,2293,6984,0.328321879
20200419,MD,12830,55061,548,A,67891,1999,522,2521,0.20706069
20200419,ME,867,14076,34,A,14943,0,20,20,1
20200419,MI,31424,78237,2391,B,109661,9301,633,9934,0.063720556
20200419,MN,2356,43360,134,A,45716,1305,143,1448,0.098756906
20200419,MO,5667,48242,176,A,53909,0,150,150,1
20200419,MP,14,42,2,0,56,0,0,0,0
20200419,MS,4274,34791,159,A,39065,0,300,300,1
20200419,MT,433,10465,10,A,10898,322,7,329,0.021276596
20200419,NC,6493,72279,172,A,78772,2208,353,2561,0.137836783
20200419,ND,585,13045,10,B,13630,610,57,667,0.085457271
20200419,NE,1287,13288,28,A,14575,749,149,898,0.165924276
20200419,NH,1342,12082,38,B,13424,517,55,572,0.096153846
20200419,NJ,85301,85387,4202,A,170688,4271,3881,8152,0.47607949
20200419,NM,1798,34834,53,A,36632,932,87,1019,0.085377821
20200419,NV,3728,27870,155,A,31598,745,102,847,0.12042503
20200419,NY,242786,374769,13869,A,617555,14969,6054,21023,0.287970318
20200419,OH,11602,75697,471,B,87299,6878,1380,8258,0.167110681
20200419,OK,2599,32966,140,B,35565,0,29,29,1
20200419,OR,1910,37128,74,A,39038,1389,66,1455,0.045360825
20200419,PA,32284,126570,1112,A,158854,3674,1215,4889,0.248517079
20200419,PR,1213,8280,62,A,9493,225,95,320,0.296875
20200419,RI,4755,29993,164,B,34748,1658,276,1934,0.142709411
20200419,SC,4377,36103,120,B,40480,1516,131,1647,0.079538555
20200419,SD,1635,10427,7,A,12062,309,93,402,0.231343284
20200419,TN,7070,90028,148,A,97098,6204,308,6512,0.047297297
20200419,TX,18923,163787,477,A,182710,5808,663,6471,0.102457116
20200419,UT,3069,60486,27,A,63555,3473,138,3611,0.038216561
20200419,VA,8537,46196,277,A,54733,2318,484,2802,0.172733762
20200419,VI,53,548,3,0,601,158,0,158,0
20200419,VT,817,11450,38,A,12267,238,4,242,0.016528926
20200419,WA,12461,143313,615,C,155774,1432,89,1521,0.058514135
20200419,WI,4346,45323,220,A,49669,1361,147,1508,0.097480106
20200419,WV,863,19168,18,B,20031,513,78,591,0.131979695
20200419,WY,309,6972,2,A,7281,755,4,759,0.005270092
20200418,AK,314,9341,9,A,9655,200,5,205,0.024390244
20200418,AL,4655,37883,146,B,42538,4565,125,4690,0.026652452
20200418,AR,1739,22402,38,A,24141,603,44,647,0.068006182
20200418,AS,0,3,0,0,3,0,0,0,0
20200418,AZ,4719,46326,177,B,51045,1603,212,1815,0.116804408
20200418,CA,28963,230703,1072,B,259666,6617,1435,8052,0.178216592
20200418,CO,9047,34260,391,A,43307,1105,372,1477,0.251861882
20200418,CT,16809,38653,1036,A,55462,0,0,0,0
20200418,DC,2666,10602,91,A,13268,435,190,625,0.304
20200418,DE,2323,11694,61,A,14017,0,0,0,0
20200418,FL,25269,221258,754,A,246527,10540,1150,11690,0.098374679
20200418,GA,17669,56539,673,A,74208,2049,475,2524,0.188193344
20200418,GU,133,943,5,0,1076,3,0,3,0
20200418,HI,553,21790,9,A,22343,474,12,486,0.024691358
20200418,IA,2513,20434,74,A,22947,974,181,1155,0.156709957
20200418,ID,1655,15292,43,A,16947,249,46,295,0.155932203
20200418,IL,29160,108244,1259,A,137404,5656,1585,7241,0.218892418
20200418,IN,10641,46232,545,B,56873,1601,487,2088,0.233237548
20200418,KS,1790,15886,86,B,17676,690,85,775,0.109677419
20200418,KY,2522,28074,137,A,30596,756,93,849,0.109540636
20200418,LA,23580,114419,1267,A,137999,5550,462,6012,0.076846307
20200418,MA,37527,124604,1983,B,162131,7409,2402,9811,0.244827235
20200418,MD,12308,53062,534,A,65370,2625,736,3361,0.218982446
20200418,ME,847,14076,32,A,14923,0,20,20,1
20200418,MI,30791,68936,2308,B,99727,0,768,768,1
20200418,MN,2213,42055,121,A,44268,1073,142,1215,0.116872428
20200418,MO,5517,48242,175,A,53759,1808,234,2042,0.114593536
20200418,MP,14,42,2,0,56,0,1,1,1
20200418,MS,3974,34791,152,A,38765,0,181,181,1
20200418,MT,426,10143,10,A,10569,321,4,325,0.012307692
20200418,NC,6140,70071,164,A,76211,2949,281,3230,0.086996904
20200418,ND,528,12435,9,B,12963,532,89,621,0.14331723
20200418,NE,1138,12539,24,A,13677,501,72,573,0.12565445
20200418,NH,1287,11565,37,B,12852,144,0,144,0
20200418,NJ,81420,81116,4070,A,162536,2134,2953,5087,0.580499312
20200418,NM,1711,33902,51,A,35613,1011,114,1125,0.101333333
20200418,NV,3626,27125,151,A,30751,887,102,989,0.103134479
20200418,NY,236732,359800,13362,A,596532,16219,7090,23309,0.304174353
20200418,OH,10222,68819,451,B,79041,0,1115,1115,1
20200418,OK,2570,32966,139,B,35536,1811,105,1916,0.05480167
20200418,OR,1844,35739,72,A,37583,1203,59,1262,0.046751189
20200418,PA,31069,122896,836,A,153965,4964,1628,6592,0.246966019
20200418,PR,1118,8055,60,A,9173,191,50,241,0.20746888
20200418,RI,4479,28335,150,B,32814,1751,302,2053,0.147101802
20200418,SC,4246,34587,119,B,38833,2234,315,2549,0.123577874
20200418,SD,1542,10118,7,A,11660,467,131,598,0.219063545
20200418,TN,6762,83824,145,A,90586,3140,173,3313,0.052218533
20200418,TX,18260,157979,453,A,176239,5814,889,6703,0.132627182
20200418,UT,2931,57013,25,A,59944,4047,126,4173,0.030194105
20200418,VA,8053,43878,258,A,51931,2372,562,2934,0.191547376
20200418,VI,53,390,3,0,443,17,2,19,0.105263158
20200418,VT,813,11212,38,A,12025,399,11,410,0.026829268
20200418,WA,12372,141881,598,C,154253,2056,169,2225,0.075955056
20200418,WI,4199,43962,211,A,48161,1597,154,1751,0.087949743
20200418,WV,785,18655,16,B,19440,728,31,759,0.040843215
20200418,WY,305,6217,2,A,6522,86,9,95,0.094736842
20200417,AK,309,9141,9,A,9450,706,9,715,0.012587413
20200417,AL,4530,33318,144,B,37848,1272,185,1457,0.126973233
20200417,AR,1695,21799,37,A,23494,744,75,819,0.091575092
20200417,AS,0,3,0,0,3,0,0,0,0
20200417,AZ,4507,44723,169,B,49230,1559,273,1832,0.149017467
20200417,CA,27528,224086,985,B,251614,3868,1346,5214,0.258151132
20200417,CO,8675,33155,374,A,41830,902,395,1297,0.304548959
20200417,CT,16809,38653,1036,A,55462,1415,925,2340,0.395299145
20200417,DC,2476,10167,86,A,12643,367,126,493,0.255578093
20200417,DE,2323,11694,61,A,14017,419,248,667,0.371814093
20200417,FL,24119,210718,699,A,234837,14367,1222,15589,0.078388607
20200417,GA,17194,54490,650,A,71684,2220,1525,3745,0.407209613
20200417,GU,133,940,5,0,1073,70,0,70,0
20200417,HI,541,21316,9,A,21857,1146,11,1157,0.009507347
20200417,IA,2332,19460,64,A,21792,926,191,1117,0.170993733
20200417,ID,1609,15043,41,A,16652,388,22,410,0.053658537
20200417,IL,27575,102588,1134,A,130163,5732,1842,7574,0.243200422
20200417,IN,10154,44631,519,B,54785,3058,612,3670,0.166757493
20200417,KS,1705,15196,84,B,16901,662,117,779,0.150192555
20200417,KY,2429,27318,129,A,29747,1285,138,1423,0.096978215
20200417,LA,23118,108869,1213,A,131987,4815,586,5401,0.108498426
20200417,MA,35125,117195,1822,B,152320,7097,2633,9730,0.270606372
20200417,MD,11572,50437,494,A,62009,2378,788,3166,0.248894504
20200417,ME,827,14076,29,A,14903,0,31,31,1
20200417,MI,30023,68936,2227,B,98959,3913,760,4673,0.162636422
20200417,MN,2071,40982,111,A,43053,1219,159,1378,0.115384615
20200417,MO,5283,46434,165,A,51717,897,172,1069,0.160898036
20200417,MP,13,42,2,0,55,15,0,15,0
20200417,MS,3793,34791,140,A,38584,0,169,169,1
20200417,MT,422,9822,8,A,10244,301,7,308,0.022727273
20200417,NC,5859,67122,152,A,72981,1670,394,2064,0.190891473
20200417,ND,439,11903,9,B,12342,592,46,638,0.072100313
20200417,NE,1066,12038,24,A,13104,696,114,810,0.140740741
20200417,NH,1287,11421,37,B,12708,394,148,542,0.273062731
20200417,NJ,78467,78982,3840,A,157449,2469,3150,5619,0.560597971
20200417,NM,1597,32891,44,A,34488,981,113,1094,0.103290676
20200417,NV,3524,26238,142,A,29762,1108,203,1311,0.154843631
20200417,NY,229642,343581,12822,A,573223,15286,7358,22644,0.32494259
20200417,OH,9107,68819,418,B,77926,2393,693,3086,0.224562541
20200417,OK,2465,31155,136,B,33620,2613,108,2721,0.03969129
20200417,OR,1785,34536,70,A,36321,1334,49,1383,0.035430224
20200417,PA,29441,117932,756,A,147373,4197,1706,5903,0.28900559
20200417,PR,1068,7864,58,A,8932,549,25,574,0.043554007
20200417,RI,4177,26584,118,B,30761,2358,339,2697,0.125695217
20200417,SC,3931,32353,109,B,36284,1276,275,1551,0.177304965
20200417,SD,1411,9651,7,A,11062,412,100,512,0.1953125
20200417,TN,6589,80684,142,A,87273,1897,327,2224,0.147032374
20200417,TX,17371,152165,428,A,169536,10073,916,10989,0.083356083
20200417,UT,2805,52966,23,A,55771,5971,122,6093,0.020022977
20200417,VA,7491,41506,231,A,48997,1951,602,2553,0.235801018
20200417,VI,51,373,2,0,424,16,0,16,0
20200417,VT,802,10813,35,A,11615,554,10,564,0.017730496
20200417,WA,12203,139825,585,C,152028,4028,341,4369,0.078049897
20200417,WI,4045,42365,205,A,46410,1391,170,1561,0.108904548
20200417,WV,754,17927,13,B,18681,360,15,375,0.04
20200417,WY,296,6131,2,A,6427,0,0,0,0
20200416,AK,300,8435,9,A,8735,64,7,71,0.098591549
20200416,AL,4345,32046,133,B,36391,2082,232,2314,0.100259291
20200416,AR,1620,21055,37,A,22675,790,51,841,0.060642093
20200416,AS,0,3,0,0,3,0,0,0,0
20200416,AZ,4234,43164,150,B,47398,1816,272,2088,0.130268199
20200416,CA,26182,220218,890,B,246400,28156,1758,29914,0.05876847
20200416,CO,8280,32253,357,A,40533,614,339,953,0.355718783
20200416,CT,15884,37238,971,A,53122,1850,1129,2979,0.378986237
20200416,DC,2350,9800,81,A,12150,472,153,625,0.2448
20200416,DE,2075,11275,52,A,13350,187,61,248,0.245967742
20200416,FL,22897,196351,646,A,219248,5353,386,5739,0.067259104
20200416,GA,15669,52270,587,A,67939,3167,682,3849,0.17718888
20200416,GU,133,870,5,0,1003,27,0,27,0
20200416,HI,530,20170,9,A,20700,884,13,897,0.014492754
20200416,IA,2141,18534,60,A,20675,660,146,806,0.181141439
20200416,ID,1587,14655,41,A,16242,721,123,844,0.145734597
20200416,IL,25733,96856,1072,A,122589,4520,1140,5660,0.201413428
20200416,IN,9542,41573,477,B,51115,2132,587,2719,0.215888194
20200416,KS,1588,14534,80,B,16122,1360,94,1454,0.064649243
20200416,KY,2291,26033,122,A,28324,546,81,627,0.129186603
20200416,LA,22532,104054,1156,A,126586,4077,581,4658,0.124731644
20200416,MA,32492,110098,1667,B,142590,7308,2522,9830,0.256561546
20200416,MD,10784,48059,459,A,58843,2328,752,3080,0.244155844
20200416,ME,796,14076,27,A,14872,0,26,26,1
20200416,MI,29263,65023,2093,B,94286,3385,1204,4589,0.262366529
20200416,MN,1912,39763,94,A,41675,1330,103,1433,0.071877181
20200416,MO,5111,45537,152,A,50648,1420,216,1636,0.13202934
20200416,MP,13,27,2,0,40,0,0,0,0
20200416,MS,3624,34791,129,A,38415,0,264,264,1
20200416,MT,415,9521,7,A,9936,342,11,353,0.031161473
20200416,NC,5465,65452,131,A,70917,2748,342,3090,0.110679612
20200416,ND,393,11311,9,B,11704,359,28,387,0.072351421
20200416,NE,952,11342,21,A,12294,514,51,565,0.090265487
20200416,NH,1139,11027,32,B,12166,0,0,0,0
20200416,NJ,75317,76513,3518,A,151830,3522,4287,7809,0.548981944
20200416,NM,1484,31910,36,A,33394,467,77,544,0.141544118
20200416,NV,3321,25130,137,A,28451,686,110,796,0.138190955
20200416,NY,222284,328295,12192,A,550579,16062,8505,24567,0.346196117
20200416,OH,8414,66426,389,B,74840,2665,623,3288,0.189476886
20200416,OK,2357,28542,131,B,30899,1586,94,1680,0.055952381
20200416,OR,1736,33202,64,A,34938,1514,73,1587,0.04599874
20200416,PA,27735,113735,707,A,141470,2641,1245,3886,0.320380854
20200416,PR,1043,7315,56,A,8358,490,69,559,0.123434705
20200416,RI,3838,24226,105,B,28064,1858,309,2167,0.142593447
20200416,SC,3656,31077,107,B,34733,0,0,0,0
20200416,SD,1311,9239,7,A,10550,548,143,691,0.206946454
20200416,TN,6262,78787,141,A,85049,3970,183,4153,0.044064532
20200416,TX,16455,142092,393,A,158547,5774,963,6737,0.142941962
20200416,UT,2683,46995,21,A,49678,1923,141,2064,0.068313953
20200416,VA,6889,39555,208,A,46444,1886,389,2275,0.170989011
20200416,VI,51,357,1,0,408,26,0,26,0
20200416,VT,792,10259,35,A,11051,346,13,359,0.036211699
20200416,WA,11862,135797,571,C,147659,3968,304,4272,0.071161049
20200416,WI,3875,40974,197,A,44849,1648,154,1802,0.085460599
20200416,WV,739,17567,13,B,18306,613,37,650,0.056923077
20200416,WY,296,6131,2,A,6427,89,9,98,0.091836735
20200415,AK,293,8371,9,A,8664,308,8,316,0.025316456
20200415,AL,4113,29964,121,B,34077,723,237,960,0.246875
20200415,AR,1569,20265,33,A,21834,614,89,703,0.126600284
20200415,AS,0,3,0,0,3,0,0,0,0
20200415,AZ,3962,41348,142,B,45310,1058,156,1214,0.128500824
20200415,CA,24424,192062,821,B,216486,13192,1086,14278,0.076061073
20200415,CO,7941,31639,329,A,39580,588,250,838,0.298329356
20200415,CT,14755,35388,868,A,50143,3536,766,4302,0.178056718
20200415,DC,2197,9328,72,A,11525,102,139,241,0.576763485
20200415,DE,2014,11088,46,A,13102,545,253,798,0.317042607
20200415,FL,22511,190998,609,A,213509,9185,1144,10329,0.110756124
20200415,GA,14987,49103,552,A,64090,1531,764,2295,0.332897603
20200415,GU,133,843,5,0,976,32,0,32,0
20200415,HI,517,19286,9,A,19803,370,13,383,0.033942559
20200415,IA,1995,17874,53,A,19869,888,96,984,0.097560976
20200415,ID,1464,13934,39,A,15398,273,11,284,0.038732394
20200415,IL,24593,92336,948,A,116929,4967,1346,6313,0.213210835
20200415,IN,8955,39441,436,B,48396,1951,428,2379,0.179907524
20200415,KS,1494,13174,76,B,14668,453,68,521,0.130518234
20200415,KY,2210,25487,115,A,27697,852,162,1014,0.159763314
20200415,LA,21951,99977,1103,A,121928,3073,433,3506,0.123502567
20200415,MA,29970,102790,1502,B,132760,3970,1861,5831,0.319156234
20200415,MD,10032,45731,413,A,55763,1470,560,2030,0.275862069
20200415,ME,770,14076,24,A,14846,2468,36,2504,0.014376997
20200415,MI,28059,61638,1921,B,89697,2413,1058,3471,0.304811294
20200415,MN,1809,38433,87,A,40242,887,114,1001,0.113886114
20200415,MO,4895,44117,147,A,49012,825,209,1034,0.20212766
20200415,MP,13,27,2,0,40,0,0,0,0
20200415,MS,3360,34791,122,A,38151,0,273,273,1
20200415,MT,404,9179,7,A,9583,344,5,349,0.014326648
20200415,NC,5123,62704,117,A,67827,2689,99,2788,0.035509326
20200415,ND,365,10952,9,B,11317,377,24,401,0.059850374
20200415,NE,901,10828,20,A,11729,342,30,372,0.080645161
20200415,NH,1139,11027,32,B,12166,437,119,556,0.214028777
20200415,NJ,71030,72991,3156,A,144021,2041,2206,4247,0.519425477
20200415,NM,1407,31443,36,A,32850,818,62,880,0.070454545
20200415,NV,3211,24444,131,A,27655,871,123,994,0.123742455
20200415,NY,213779,312233,11586,A,526012,15298,11571,26869,0.430644981
20200415,OH,7791,63761,361,B,71552,3040,511,3551,0.143903126
20200415,OK,2263,26956,123,B,29219,871,79,950,0.083157895
20200415,OR,1663,31688,58,A,33351,958,30,988,0.030364372
20200415,PA,26490,111094,647,A,137584,2808,1145,3953,0.289653428
20200415,PR,974,6825,51,A,7799,541,51,592,0.086148649
20200415,RI,3529,22368,87,B,25897,2719,278,2997,0.092759426
20200415,SC,3656,31077,107,B,34733,758,103,861,0.119628339
20200415,SD,1168,8691,6,A,9859,383,180,563,0.319715808
20200415,TN,6079,74817,135,A,80896,1809,256,2065,0.123970944
20200415,TX,15492,136318,364,A,151810,4475,868,5343,0.162455549
20200415,UT,2542,45072,20,A,47614,1008,130,1138,0.114235501
20200415,VA,6500,37669,195,A,44169,1077,329,1406,0.233997155
20200415,VI,51,331,1,0,382,5,0,5,0
20200415,VT,779,9913,30,A,10692,422,9,431,0.020881671
20200415,WA,11558,131829,551,C,143387,3792,324,4116,0.078717201
20200415,WI,3721,39326,182,A,43047,1329,166,1495,0.111036789
20200415,WV,702,16954,10,B,17656,556,62,618,0.100323625
20200415,WY,287,6042,2,A,6329,353,12,365,0.032876712
20200414,AK,285,8063,9,A,8348,510,8,518,0.015444015
20200414,AL,3876,29241,110,B,33117,3793,142,3935,0.036086404
20200414,AR,1480,19651,30,A,21131,257,70,327,0.214067278
20200414,AS,0,3,0,0,3,0,0,0,0
20200414,AZ,3806,40290,131,B,44096,645,104,749,0.138851802
20200414,CA,23338,178870,758,B,202208,10336,990,11326,0.0874095
20200414,CO,7691,31051,308,A,38742,1201,7,1208,0.005794702
20200414,CT,13989,31852,671,A,45841,924,608,1532,0.396866841
20200414,DC,2058,9226,67,A,11284,247,103,350,0.294285714
20200414,DE,1761,10543,41,A,12304,348,136,484,0.280991736
20200414,FL,21367,181813,537,A,203180,6207,766,6973,0.109852287
20200414,GA,14223,47572,501,A,61795,3866,908,4774,0.1901969
20200414,GU,133,811,5,0,944,41,0,41,0
20200414,HI,504,18916,9,A,19420,571,5,576,0.008680556
20200414,IA,1899,16986,49,A,18885,0,189,189,1
20200414,ID,1453,13661,33,A,15114,206,27,233,0.115879828
20200414,IL,23247,87369,868,A,110616,3626,1222,4848,0.252062706
20200414,IN,8527,37490,388,B,46017,1187,291,1478,0.196887686
20200414,KS,1426,12721,69,B,14147,233,50,283,0.176678445
20200414,KY,2048,24635,104,A,26683,732,85,817,0.104039168
20200414,LA,21518,96904,1013,A,118422,9829,502,10331,0.048591617
20200414,MA,28109,98820,1329,B,126929,3320,1315,4635,0.283710895
20200414,MD,9472,44261,302,A,53733,1446,536,1982,0.270433905
20200414,ME,734,11608,20,A,12342,0,36,36,1
20200414,MI,27001,59225,1768,B,86226,2216,1366,3582,0.3813512
20200414,MN,1695,37546,79,A,39241,769,45,814,0.055282555
20200414,MO,4686,43292,133,A,47978,2252,298,2550,0.116862745
20200414,MP,13,27,2,0,40,0,2,2,1
20200414,MS,3087,34791,111,A,37878,6749,145,6894,0.021032782
20200414,MT,399,8835,7,A,9234,131,5,136,0.036764706
20200414,NC,5024,60015,108,A,65039,1443,208,1651,0.125984252
20200414,ND,341,10575,9,B,10916,125,10,135,0.074074074
20200414,NE,871,10486,18,A,11357,328,57,385,0.148051948
20200414,NH,1020,10590,23,B,11610,368,35,403,0.086848635
20200414,NJ,68824,70950,2805,A,139774,6065,4240,10305,0.411450752
20200414,NM,1345,30625,31,A,31970,1355,100,1455,0.068728522
20200414,NV,3088,23573,120,A,26661,1080,117,1197,0.097744361
20200414,NY,202208,296935,10834,A,499143,13609,7177,20786,0.345280477
20200414,OH,7280,60721,324,B,68001,2584,305,2889,0.105572863
20200414,OK,2184,26085,108,B,28269,5295,115,5410,0.021256932
20200414,OR,1633,30730,55,A,32363,1193,49,1242,0.039452496
20200414,PA,25345,108286,584,A,133631,2693,1146,3839,0.298515238
20200414,PR,923,6284,45,A,7207,324,20,344,0.058139535
20200414,RI,3251,19649,80,B,22900,1964,275,2239,0.122822689
20200414,SC,3553,30319,97,B,33872,2213,234,2447,0.095627299
20200414,SD,988,8308,6,A,9296,174,120,294,0.408163265
20200414,TN,5823,73008,124,A,78831,2423,213,2636,0.080804249
20200414,TX,14624,131843,318,A,146467,12523,718,13241,0.054225512
20200414,UT,2412,44064,19,A,46476,640,49,689,0.071117562
20200414,VA,6171,36592,154,A,42763,938,424,1362,0.311306902
20200414,VI,51,326,1,0,377,4,0,4,0
20200414,VT,770,9491,29,A,10261,216,9,225,0.04
20200414,WA,11234,128037,542,C,139271,3932,291,4223,0.068908359
20200414,WI,3555,37997,170,A,41552,1228,127,1355,0.093726937
20200414,WV,640,16398,9,B,17038,369,14,383,0.036553525
20200414,WY,275,5689,1,A,5964,0,0,0,0
20200413,AK,277,7553,8,A,7830,-213,5,-208,-0.024038462
20200413,AL,3734,25448,99,B,29182,7390,209,7599,0.027503619
20200413,AR,1410,19394,30,A,20804,952,130,1082,0.120147874
20200413,AS,0,3,0,0,3,0,0,0,0
20200413,AZ,3702,39645,122,B,43347,1075,163,1238,0.131663974
20200413,CA,22348,168534,687,B,190882,0,554,554,1
20200413,CO,7684,29850,304,A,37534,1870,791,2661,0.29725667
20200413,CT,13381,30928,602,A,44309,1743,1346,3089,0.435739722
20200413,DC,1955,8979,53,A,10934,214,80,294,0.272108844
20200413,DE,1625,10195,35,A,11820,571,146,717,0.20362622
20200413,FL,20601,175606,483,A,196207,12208,1246,13454,0.092611863
20200413,GA,13315,43706,464,A,57021,1705,863,2568,0.33605919
20200413,GU,133,770,5,0,903,77,0,77,0
20200413,HI,499,18345,9,A,18844,863,13,876,0.014840183
20200413,IA,1710,16986,43,A,18696,981,123,1104,0.111413043
20200413,ID,1426,13455,27,A,14881,554,19,573,0.033158813
20200413,IL,22025,83743,794,A,105768,3860,1173,5033,0.233061792
20200413,IN,8236,36303,350,B,44539,1742,308,2050,0.150243902
20200413,KS,1376,12488,62,B,13864,572,39,611,0.063829787
20200413,KY,1963,23903,97,A,25866,1176,123,1299,0.094688222
20200413,LA,21016,87075,884,A,108091,3625,421,4046,0.104053386
20200413,MA,26794,95500,1211,B,122294,4037,1413,5450,0.259266055
20200413,MD,8936,42815,262,A,51751,1276,711,1987,0.357825868
20200413,ME,698,11608,19,A,12306,5520,65,5585,0.011638317
20200413,MI,25635,57009,1602,B,82644,2210,997,3207,0.310882445
20200413,MN,1650,36777,70,A,38427,977,29,1006,0.028827038
20200413,MO,4388,41040,114,A,45428,0,228,228,1
20200413,MP,11,27,2,0,38,0,0,0,0
20200413,MS,2942,28042,98,A,30984,9410,161,9571,0.016821649
20200413,MT,394,8704,7,A,9098,178,7,185,0.037837838
20200413,NC,4816,58572,86,A,63388,953,296,1249,0.236989592
20200413,ND,331,10450,8,B,10781,408,23,431,0.053364269
20200413,NE,814,10158,17,A,10972,258,23,281,0.081850534
20200413,NH,985,10222,23,B,11207,226,56,282,0.19858156
20200413,NJ,64584,64885,2443,A,129469,0,2734,2734,1
20200413,NM,1245,29270,26,A,30515,1752,71,1823,0.038946791
20200413,NV,2971,22493,114,A,25464,718,135,853,0.158264947
20200413,NY,195031,283326,10056,A,478357,10419,6337,16756,0.378192886
20200413,OH,6975,58137,274,B,65112,1498,371,1869,0.198501873
20200413,OK,2069,20790,99,B,22859,0,99,99,1
20200413,OR,1584,29537,53,A,31121,1306,57,1363,0.041819516
20200413,PA,24199,105593,524,A,129792,3536,1366,4902,0.278661771
20200413,PR,903,5960,45,A,6863,141,6,147,0.040816327
20200413,RI,2976,17685,73,B,20661,0,311,311,1
20200413,SC,3319,28106,82,B,31425,0,0,0,0
20200413,SD,868,8134,6,A,9002,311,138,449,0.307349666
20200413,TN,5610,70585,109,A,76195,5216,302,5518,0.054729975
20200413,TX,13906,119320,287,A,133226,8271,422,8693,0.048544806
20200413,UT,2363,43424,18,A,45787,1493,60,1553,0.0386349
20200413,VA,5747,35654,149,A,41401,943,473,1416,0.334039548
20200413,VI,51,322,1,0,373,23,0,23,0
20200413,VT,761,9275,28,A,10036,551,7,558,0.012544803
20200413,WA,10943,124105,526,C,135048,3777,355,4132,0.085914811
20200413,WI,3428,36769,154,A,40197,853,87,940,0.092553191
20200413,WV,626,16029,9,B,16655,383,15,398,0.037688442
20200413,WY,275,5689,1,A,5964,491,14,505,0.027722772
20200412,AK,272,7766,8,A,8038,291,15,306,0.049019608
20200412,AL,3525,18058,93,B,21583,0,334,334,1
20200412,AR,1280,18442,27,A,19722,1090,54,1144,0.047202797
20200412,AS,0,3,0,0,3,0,0,0,0
20200412,AZ,3539,38570,115,B,42109,1433,146,1579,0.092463585
20200412,CA,21794,168534,651,B,190328,15930,1179,17109,0.068911099
20200412,CO,6893,27980,274,A,34873,1837,383,2220,0.172522523
20200412,CT,12035,29185,554,A,41220,864,525,1389,0.377969762
20200412,DC,1875,8765,50,A,10640,504,97,601,0.161397671
20200412,DE,1479,9624,33,A,11103,0,0,0,0
20200412,FL,19355,163398,465,A,182753,8959,861,9820,0.087678208
20200412,GA,12452,42001,433,A,54453,2445,293,2738,0.107012418
20200412,GU,133,693,5,0,826,0,0,0,0
20200412,HI,486,17482,8,A,17968,416,21,437,0.04805492
20200412,IA,1587,16005,41,A,17592,383,77,460,0.167391304
20200412,ID,1407,12901,27,A,14308,533,11,544,0.020220588
20200412,IL,20852,79883,720,A,100735,6914,1672,8586,0.194735616
20200412,IN,7928,34561,343,B,42489,2781,493,3274,0.15058033
20200412,KS,1337,11916,56,B,13253,841,69,910,0.075824176
20200412,KY,1840,22727,94,A,24567,132,147,279,0.52688172
20200412,LA,20595,83450,840,A,104045,6549,581,7130,0.081486676
20200412,MA,25381,91463,1056,B,116844,5348,2615,7963,0.328393821
20200412,MD,8225,41539,235,A,49764,1995,531,2526,0.210213777
20200412,ME,633,6088,19,A,6721,0,17,17,1
20200412,MI,24638,54799,1487,B,79437,2778,645,3423,0.188431201
20200412,MN,1621,35800,70,A,37421,1823,194,2017,0.096182449
20200412,MO,4160,41040,110,A,45200,1892,136,2028,0.067061144
20200412,MP,11,27,2,0,38,0,0,0,0
20200412,MS,2781,18632,96,A,21413,0,139,139,1
20200412,MT,387,8526,6,A,8913,322,10,332,0.030120482
20200412,NC,4520,57619,81,A,62139,1538,208,1746,0.119129439
20200412,ND,308,10042,8,B,10350,255,15,270,0.055555556
20200412,NE,791,9900,17,A,10691,615,91,706,0.128895184
20200412,NH,929,9996,23,B,10925,388,44,432,0.101851852
20200412,NJ,61850,64885,2350,A,126735,2843,3699,6542,0.565423418
20200412,NM,1174,27518,20,A,28692,1511,83,1594,0.052070263
20200412,NV,2836,21775,112,A,24611,888,136,1024,0.1328125
20200412,NY,188694,272907,9385,A,461601,12385,8236,20621,0.399398671
20200412,OH,6604,56639,253,B,63243,2418,354,2772,0.127705628
20200412,OK,1970,20790,96,B,22760,0,102,102,1
20200412,OR,1527,28231,52,A,29758,2378,156,2534,0.061562747
20200412,PA,22833,102057,507,A,124890,3559,1178,4737,0.2486806
20200412,PR,897,5819,44,A,6716,236,109,345,0.315942029
20200412,RI,2665,17685,63,B,20350,1827,316,2143,0.147456836
20200412,SC,3319,28106,82,B,31425,1220,112,1332,0.084084084
20200412,SD,730,7823,6,A,8553,445,104,549,0.189435337
20200412,TN,5308,65369,101,A,70677,3655,194,3849,0.050402702
20200412,TX,13484,111049,271,A,124533,3077,923,4000,0.23075
20200412,UT,2303,41931,18,A,44234,1591,97,1688,0.057464455
20200412,VA,5274,34711,141,A,39985,1789,197,1986,0.099194361
20200412,VI,51,299,1,0,350,0,0,0,0
20200412,VT,754,8724,27,A,9478,661,21,682,0.030791789
20200412,WA,10588,120328,509,C,130916,1341,84,1425,0.058947368
20200412,WI,3341,35916,144,A,39257,1236,128,1364,0.093841642
20200412,WV,611,15646,8,B,16257,771,34,805,0.042236025
20200412,WY,261,5198,0,A,5459,0,0,0,0
20200411,AK,257,7475,8,A,7732,289,11,300,0.036666667
20200411,AL,3191,18058,91,B,21249,0,223,223,1
20200411,AR,1226,17352,24,A,18578,1403,55,1458,0.037722908
20200411,AS,0,3,0,0,3,0,0,0,0
20200411,AZ,3393,37137,108,B,40530,2515,281,2796,0.100500715
20200411,CA,20615,152604,609,B,173219,7213,1143,8356,0.136787937
20200411,CO,6510,26143,250,A,32653,0,0,0,0
20200411,CT,11510,28321,494,A,39831,2571,972,3543,0.274343776
20200411,DC,1778,8261,47,A,10039,566,118,684,0.17251462
20200411,DE,1479,9624,33,A,11103,-791,153,-638,-0.239811912
20200411,FL,18494,154439,438,A,172933,9140,963,10103,0.095318222
20200411,GA,12159,39556,428,A,51715,4892,676,5568,0.121408046
20200411,GU,133,693,5,0,826,31,3,34,0.088235294
20200411,HI,465,17066,8,A,17531,1359,23,1382,0.016642547
20200411,IA,1510,15622,34,A,17132,1057,122,1179,0.103477523
20200411,ID,1396,12368,25,A,13764,627,43,670,0.064179104
20200411,IL,19180,72969,677,A,92149,3329,1293,4622,0.279749026
20200411,IN,7435,31780,330,B,39215,3647,528,4175,0.126467066
20200411,KS,1268,11075,55,B,12343,827,102,929,0.109795479
20200411,KY,1693,22595,90,A,24288,0,0,0,0
20200411,LA,20014,76901,806,A,96915,3874,761,4635,0.164185545
20200411,MA,22766,86115,946,B,108881,4551,1888,6439,0.293213232
20200411,MD,7694,39544,206,A,47238,2064,726,2790,0.260215054
20200411,ME,616,6088,19,A,6704,0,30,30,1
20200411,MI,23993,52021,1392,B,76014,2760,1210,3970,0.304785894
20200411,MN,1427,33977,64,A,35404,1419,91,1510,0.060264901
20200411,MO,4024,39148,109,A,43172,2207,225,2432,0.092516447
20200411,MP,11,27,2,0,38,0,0,0,0
20200411,MS,2642,18632,93,A,21274,0,173,173,1
20200411,MT,377,8204,6,A,8581,272,12,284,0.042253521
20200411,NC,4312,56081,80,A,60393,2344,404,2748,0.147016012
20200411,ND,293,9787,7,B,10080,457,15,472,0.031779661
20200411,NE,700,9285,17,A,9985,566,65,631,0.103011094
20200411,NH,885,9608,22,B,10493,469,66,535,0.123364486
20200411,NJ,58151,62042,2183,A,120193,3107,3563,6670,0.534182909
20200411,NM,1091,26007,19,A,27098,0,0,0,0
20200411,NV,2700,20887,102,A,23587,722,116,838,0.138424821
20200411,NY,180458,260522,8627,A,440980,13149,9946,23095,0.430655986
20200411,OH,6250,54221,247,B,60471,1526,372,1898,0.195995785
20200411,OK,1868,20790,94,B,22658,420,74,494,0.149797571
20200411,OR,1371,25853,48,A,27224,1547,50,1597,0.031308704
20200411,PA,21655,98498,494,A,120153,5458,1676,7134,0.234931315
20200411,PR,788,5583,42,A,6371,462,63,525,0.12
20200411,RI,2349,15858,56,B,18207,3577,334,3911,0.085400153
20200411,SC,3207,26886,80,B,30093,1768,142,1910,0.07434555
20200411,SD,626,7378,6,A,8004,267,90,357,0.25210084
20200411,TN,5114,61714,101,A,66828,3777,252,4029,0.062546538
20200411,TX,12561,107972,254,A,120533,3925,890,4815,0.184839045
20200411,UT,2206,40340,18,A,42546,1680,104,1784,0.058295964
20200411,VA,5077,32922,130,A,37999,1972,568,2540,0.223622047
20200411,VI,51,299,1,0,350,26,1,27,0.037037037
20200411,VT,733,8063,25,A,8796,561,20,581,0.034423408
20200411,WA,10504,118987,494,C,129491,1888,154,2042,0.075416259
20200411,WI,3213,34680,137,A,37893,1455,145,1600,0.090625
20200411,WV,577,14875,5,B,15452,874,23,897,0.025641026
20200411,WY,261,5198,0,A,5459,462,8,470,0.017021277
20200410,AK,246,7186,7,A,7432,198,11,209,0.052631579
20200410,AL,2968,18058,80,B,21026,0,199,199,1
20200410,AR,1171,15949,23,A,17120,2117,52,2169,0.023974182
20200410,AS,0,3,0,0,3,0,0,0,0
20200410,AZ,3112,34622,97,B,37734,462,94,556,0.169064748
20200410,CA,19472,145391,541,B,164863,200,1163,1363,0.853264857
20200410,CO,6510,26143,250,A,32653,2599,855,3454,0.247539085
20200410,CT,10538,25750,448,A,36288,2032,754,2786,0.270638909
20200410,DC,1660,7695,38,A,9355,494,137,631,0.217115689
20200410,DE,1326,10415,23,A,11741,1732,119,1851,0.064289573
20200410,FL,17531,145299,390,A,162830,9114,1167,10281,0.113510359
20200410,GA,11483,34664,416,A,46147,4145,917,5062,0.181153694
20200410,GU,130,662,4,0,792,69,2,71,0.028169014
20200410,HI,442,15707,6,A,16149,391,7,398,0.01758794
20200410,IA,1388,14565,31,A,15953,862,118,980,0.120408163
20200410,ID,1353,11741,24,A,13094,442,121,563,0.214920071
20200410,IL,17887,69640,596,A,87527,5205,1465,6670,0.21964018
20200410,IN,6907,28133,300,B,35040,2351,556,2907,0.19126247
20200410,KS,1166,10248,50,B,11414,579,60,639,0.093896714
20200410,KY,1693,22595,90,A,24288,2140,347,2487,0.139525533
20200410,LA,19253,73027,755,A,92280,4391,970,5361,0.180936392
20200410,MA,20878,81564,832,B,102442,5418,2035,7453,0.273044412
20200410,MD,6968,37480,171,A,44448,2136,783,2919,0.268242549
20200410,ME,586,6088,17,A,6674,0,26,26,1
20200410,MI,22783,49261,1281,B,72044,3711,1279,4990,0.256312625
20200410,MN,1336,32558,57,A,33894,1506,94,1600,0.05875
20200410,MO,3799,36941,96,A,40740,1986,260,2246,0.115761354
20200410,MP,11,27,2,0,38,0,0,0,0
20200410,MS,2469,18632,82,A,21101,0,209,209,1
20200410,MT,365,7932,6,A,8297,426,11,437,0.025171625
20200410,NC,3908,53737,74,A,57645,9579,257,9836,0.026128508
20200410,ND,278,9330,6,B,9608,609,9,618,0.014563107
20200410,NE,635,8719,15,A,9354,603,68,671,0.101341282
20200410,NH,819,9139,21,B,9958,376,31,407,0.076167076
20200410,NJ,54588,58935,1932,A,113523,2770,3561,6331,0.562470384
20200410,NM,1091,26007,19,A,27098,3065,226,3291,0.068672136
20200410,NV,2584,20165,86,A,22749,850,128,978,0.130879346
20200410,NY,170512,247373,7844,A,417885,15761,10575,26336,0.401541616
20200410,OH,5878,52695,231,B,58573,2222,366,2588,0.141421947
20200410,OK,1794,20370,88,B,22164,1775,110,1885,0.058355438
20200410,OR,1321,24306,44,A,25627,0,0,0,0
20200410,PA,19979,93040,416,A,113019,5666,1751,7417,0.236079277
20200410,PR,725,5121,39,A,5846,418,42,460,0.091304348
20200410,RI,2015,12281,49,B,14296,1599,288,1887,0.152623211
20200410,SC,3065,25118,72,B,28183,543,273,816,0.334558824
20200410,SD,536,7111,6,A,7647,411,89,500,0.178
20200410,TN,4862,57937,98,A,62799,2722,228,2950,0.077288136
20200410,TX,11671,104047,226,A,115718,8143,1441,9584,0.150354758
20200410,UT,2102,38660,17,A,40762,2263,126,2389,0.052741733
20200410,VA,4509,30950,121,A,35459,1966,467,2433,0.191944102
20200410,VI,50,273,1,0,323,22,4,26,0.153846154
20200410,VT,713,7502,24,A,8215,284,33,317,0.104100946
20200410,WA,10350,117099,476,C,127449,3935,301,4236,0.071057602
20200410,WI,3068,33225,128,A,36293,1801,183,1984,0.092237903
20200410,WV,554,14001,5,B,14555,661,31,692,0.044797688
20200410,WY,253,4736,0,A,4989,816,23,839,0.027413588
20200409,AK,235,6988,7,A,7223,146,9,155,0.058064516
20200409,AL,2769,18058,74,B,20827,1305,400,1705,0.234604106
20200409,AR,1119,13832,21,A,14951,302,119,421,0.282660333
20200409,AS,0,3,0,0,3,0,0,0,0
20200409,AZ,3018,34160,89,B,37178,2322,292,2614,0.111706197
20200409,CA,18309,145191,492,B,163500,17884,1352,19236,0.070284883
20200409,CO,5655,23544,193,A,29199,879,226,1105,0.204524887
20200409,CT,9784,23718,380,A,33502,2463,2003,4466,0.448499776
20200409,DC,1523,7201,32,A,8724,358,83,441,0.188208617
20200409,DE,1207,8683,23,A,9890,1055,279,1334,0.209145427
20200409,FL,16364,136185,354,A,152549,8506,909,9415,0.096548062
20200409,GA,10566,30519,379,A,41085,1633,665,2298,0.289382071
20200409,GU,128,593,4,0,721,31,3,34,0.088235294
20200409,HI,435,15316,5,A,15751,577,25,602,0.041528239
20200409,IA,1270,13703,29,A,14973,882,125,1007,0.124131082
20200409,ID,1232,11299,18,A,12531,611,22,633,0.034755134
20200409,IL,16422,64435,528,A,80857,4447,1344,5791,0.232084269
20200409,IN,6351,25782,245,B,32133,856,408,1264,0.32278481
20200409,KS,1106,9669,42,B,10775,532,60,592,0.101351351
20200409,KY,1346,20455,73,A,21801,0,197,197,1
20200409,LA,18283,68636,702,A,86919,4260,1253,5513,0.227280972
20200409,MA,18843,76146,725,B,94989,5297,2151,7448,0.288802363
20200409,MD,6185,35344,138,A,41529,2411,656,3067,0.213889795
20200409,ME,560,6088,16,A,6648,0,23,23,1
20200409,MI,21504,45550,1076,B,67054,0,915,915,1
20200409,MN,1242,31052,50,A,32294,1453,88,1541,0.057105775
20200409,MO,3539,34955,77,A,38494,4172,212,4384,0.048357664
20200409,MP,11,27,2,0,38,0,0,0,0
20200409,MS,2260,18632,76,A,20892,0,257,257,1
20200409,MT,354,7506,6,A,7860,440,22,462,0.047619048
20200409,NC,3651,44158,65,A,47809,4597,225,4822,0.046661136
20200409,ND,269,8721,5,B,8990,420,18,438,0.04109589
20200409,NE,567,8116,14,A,8683,674,48,722,0.066481994
20200409,NH,788,8763,18,B,9551,374,0,374,0
20200409,NJ,51027,56165,1700,A,107192,3186,3590,6776,0.529811098
20200409,NM,865,22942,16,A,23807,1491,71,1562,0.045454545
20200409,NV,2456,19315,80,A,21771,1067,138,1205,0.114522822
20200409,NY,159937,231612,7067,A,391549,15775,10621,26396,0.402371571
20200409,OH,5512,50473,213,B,55985,2280,364,2644,0.137670197
20200409,OK,1684,18595,80,B,20279,6774,160,6934,0.023074704
20200409,OR,1321,24306,44,A,25627,981,82,1063,0.077140169
20200409,PA,18228,87374,338,A,105602,5075,1989,7064,0.281568516
20200409,PR,683,4703,33,A,5386,437,63,500,0.126
20200409,RI,1727,10682,43,B,12409,0,277,277,1
20200409,SC,2792,24575,67,B,27367,2493,240,2733,0.087815587
20200409,SD,447,6700,6,A,7147,345,54,399,0.135338346
20200409,TN,4634,55215,94,A,59849,2959,272,3231,0.084184463
20200409,TX,10230,95904,199,A,106134,8999,877,9876,0.088801134
20200409,UT,1976,36397,13,A,38373,2127,130,2257,0.057598582
20200409,VA,4042,28984,109,A,33026,1984,397,2381,0.166736665
20200409,VI,46,251,1,0,297,9,1,10,0.1
20200409,VT,680,7218,23,A,7898,217,49,266,0.184210526
20200409,WA,10049,113164,459,A,123213,3832,362,4194,0.086313782
20200409,WI,2885,31424,111,A,34309,1309,129,1438,0.089707928
20200409,WV,523,13340,5,B,13863,1257,61,1318,0.046282246
20200409,WY,230,3920,0,A,4150,77,9,86,0.104651163
20200408,AK,226,6842,7,A,7068,142,13,155,0.083870968
20200408,AL,2369,16753,66,B,19122,3956,250,4206,0.059438897
20200408,AR,1000,13530,18,A,14530,838,54,892,0.060538117
20200408,AS,0,3,0,0,3,0,0,0,0
20200408,AZ,2726,31838,80,B,34564,1038,151,1189,0.126997477
20200408,CA,16957,127307,442,B,144264,11943,1092,13035,0.083774453
20200408,CO,5429,22665,179,A,28094,962,257,1219,0.210828548
20200408,CT,7781,21255,277,A,29036,0,0,0,0
20200408,DC,1440,6843,27,A,8283,231,229,460,0.497826087
20200408,DE,928,7628,16,A,8556,0,0,0,0
20200408,FL,15455,127679,309,A,143134,4264,708,4972,0.142397426
20200408,GA,9901,28886,362,A,38787,3991,1083,5074,0.213441072
20200408,GU,125,562,4,0,687,33,4,37,0.108108108
20200408,HI,410,14739,5,A,15149,1584,23,1607,0.014312383
20200408,IA,1145,12821,27,A,13966,1151,97,1248,0.077724359
20200408,ID,1210,10688,15,A,11898,612,40,652,0.061349693
20200408,IL,15078,59988,462,A,75066,4805,1529,6334,0.241395643
20200408,IN,5943,24926,203,B,30869,1669,436,2105,0.207125891
20200408,KS,1046,9137,38,B,10183,523,146,669,0.218236173
20200408,KY,1149,20455,65,A,21604,1508,141,1649,0.085506367
20200408,LA,17030,64376,652,A,81406,6005,746,6751,0.110502148
20200408,MA,16692,70849,615,B,87541,4579,1588,6167,0.257499595
20200408,MD,5529,32933,124,A,38462,5677,1158,6835,0.169422092
20200408,ME,537,6088,14,A,6625,0,18,18,1
20200408,MI,20589,45550,959,B,66139,0,766,766,1
20200408,MN,1154,29599,39,A,30753,1408,85,1493,0.056932351
20200408,MO,3327,30783,58,A,34110,1851,290,2141,0.135450724
20200408,MP,11,27,2,0,38,12,3,15,0.2
20200408,MS,2003,18632,67,A,20635,0,88,88,1
20200408,MT,332,7066,6,A,7398,400,13,413,0.031476998
20200408,NC,3426,39561,53,A,42987,1700,205,1905,0.107611549
20200408,ND,251,8301,4,B,8552,835,14,849,0.016489988
20200408,NE,519,7442,12,A,7961,631,72,703,0.102418208
20200408,NH,788,8389,18,B,9177,370,73,443,0.164785553
20200408,NJ,47437,52979,1504,A,100416,2421,3021,5442,0.555126792
20200408,NM,794,21451,13,A,22245,312,108,420,0.257142857
20200408,NV,2318,18248,71,A,20566,1696,231,1927,0.119875454
20200408,NY,149316,215837,6268,A,365153,14642,10453,25095,0.416537159
20200408,OH,5148,48193,193,B,53341,2137,366,2503,0.146224531
20200408,OK,1524,11821,79,B,13345,0,52,52,1
20200408,OR,1239,23325,33,A,24564,1499,58,1557,0.037251124
20200408,PA,16239,82299,309,A,98538,5580,1680,7260,0.231404959
20200408,PR,620,4266,24,A,4886,300,47,347,0.135446686
20200408,RI,1450,10682,35,B,12132,1605,220,1825,0.120547945
20200408,SC,2552,22082,63,B,24634,819,135,954,0.141509434
20200408,SD,393,6355,6,A,6748,407,73,480,0.152083333
20200408,TN,4362,52256,79,A,56618,3520,224,3744,0.05982906
20200408,TX,9353,86905,177,A,96258,6518,1091,7609,0.143382836
20200408,UT,1846,34270,13,A,36116,1361,108,1469,0.073519401
20200408,VA,3645,27000,75,A,30645,1688,312,2000,0.156
20200408,VI,45,242,1,0,287,20,2,22,0.090909091
20200408,VT,631,7001,23,A,7632,356,23,379,0.060686016
20200408,WA,9687,109332,443,A,119019,4389,341,4730,0.072093023
20200408,WI,2756,30115,99,A,32871,1603,178,1781,0.099943852
20200408,WV,462,12083,4,B,12545,436,50,486,0.102880658
20200408,WY,221,3843,0,A,4064,54,5,59,0.084745763
20200407,AK,213,6700,6,A,6913,8,22,30,0.733333333
20200407,AL,2119,12797,56,B,14916,0,151,151,1
20200407,AR,946,12692,16,A,13638,722,71,793,0.089533417
20200407,AS,0,3,0,0,3,0,0,0,0
20200407,AZ,2575,30800,73,B,33375,722,119,841,0.141498216
20200407,CA,15865,115364,374,B,131229,12269,1529,13798,0.110813161
20200407,CO,5172,21703,150,A,26875,880,222,1102,0.201451906
20200407,CT,7781,21255,277,A,29036,1475,875,2350,0.372340426
20200407,DC,1211,6612,22,A,7823,256,114,370,0.308108108
20200407,DE,928,7628,16,A,8556,1307,255,1562,0.163252241
20200407,FL,14747,123415,296,A,138162,13465,1423,14888,0.095580333
20200407,GA,8818,24895,329,A,33713,935,1504,2439,0.616646166
20200407,GU,121,529,4,0,650,24,8,32,0.25
20200407,HI,387,13155,5,A,13542,0,16,16,1
20200407,IA,1048,11670,26,A,12718,1017,102,1119,0.091152815
20200407,ID,1170,10076,13,A,11246,182,69,251,0.274900398
20200407,IL,13549,55183,380,A,68732,4503,1287,5790,0.222279793
20200407,IN,5507,23257,173,B,28764,2010,563,2573,0.218810727
20200407,KS,900,8614,27,B,9514,375,55,430,0.127906977
20200407,KY,1008,18947,59,A,19955,1135,53,1188,0.044612795
20200407,LA,16284,58371,582,A,74655,4072,1417,5489,0.258152669
20200407,MA,15104,66270,515,B,81374,3550,1365,4915,0.277721261
20200407,MD,4371,27256,103,A,31627,1684,326,2010,0.162189055
20200407,ME,519,6088,12,A,6607,0,20,20,1
20200407,MI,19823,45550,845,B,65373,2430,973,3403,0.285924185
20200407,MN,1069,28191,34,A,29260,1049,83,1132,0.073321555
20200407,MO,3037,28932,53,A,31969,1819,315,2134,0.147610122
20200407,MP,8,15,2,0,23,2,0,2,0
20200407,MS,1915,18632,59,A,20547,0,177,177,1
20200407,MT,319,6666,6,A,6985,175,20,195,0.102564103
20200407,NC,3221,37861,46,A,41082,5,351,356,0.985955056
20200407,ND,237,7466,4,B,7703,478,12,490,0.024489796
20200407,NE,447,6811,10,A,7258,433,38,471,0.080679406
20200407,NH,715,8019,9,B,8734,318,46,364,0.126373626
20200407,NJ,44416,50558,1232,A,94974,2616,3326,5942,0.559744194
20200407,NM,686,21139,12,A,21825,2627,62,2689,0.023056898
20200407,NV,2087,16552,58,A,18639,876,134,1010,0.132673267
20200407,NY,138863,201195,5489,A,340058,11073,8174,19247,0.424689562
20200407,OH,4782,46056,167,B,50838,2128,332,2460,0.13495935
20200407,OK,1472,11821,67,B,13293,10399,145,10544,0.013751897
20200407,OR,1181,21826,33,A,23007,1157,49,1206,0.040630182
20200407,PA,14559,76719,240,A,91278,5845,1579,7424,0.212688578
20200407,PR,573,3966,23,A,4539,534,60,594,0.101010101
20200407,RI,1230,9077,30,B,10307,1678,148,1826,0.081051479
20200407,SC,2417,21263,51,B,23680,4336,368,4704,0.078231293
20200407,SD,320,5948,6,A,6268,216,32,248,0.129032258
20200407,TN,4138,48736,72,A,52874,5188,336,5524,0.060825489
20200407,TX,8262,80387,154,A,88649,2306,986,3292,0.299513973
20200407,UT,1738,32909,13,A,34647,1190,63,1253,0.05027933
20200407,VA,3333,25312,63,A,28645,3669,455,4124,0.110329777
20200407,VI,43,222,1,0,265,0,0,0,0
20200407,VT,608,6645,23,A,7253,484,33,517,0.063829787
20200407,WA,9346,104943,429,A,114289,4740,409,5149,0.0794329
20200407,WI,2578,28512,92,A,31090,1938,138,2076,0.066473988
20200407,WV,412,11647,4,B,12059,2052,67,2119,0.031618688
20200407,WY,216,3789,0,A,4005,70,6,76,0.078947368
20200406,AK,191,6692,6,A,6883,593,6,599,0.010016694
20200406,AL,1968,12797,50,B,14765,1515,172,1687,0.101956135
20200406,AR,875,11970,16,A,12845,1558,45,1603,0.028072364
20200406,AS,0,3,0,0,3,0,0,0,0
20200406,AZ,2456,30078,65,B,32534,4937,187,5124,0.036494926
20200406,CA,14336,103095,343,B,117431,0,898,898,1
20200406,CO,4950,20823,140,A,25773,1488,385,1873,0.205552589
20200406,CT,6906,19780,206,A,26686,2185,1231,3416,0.360362998
20200406,DC,1097,6356,24,A,7453,520,99,619,0.15993538
20200406,DE,673,6321,14,A,6994,0,0,0,0
20200406,FL,13324,109950,236,A,123274,8697,1173,9870,0.118844985
20200406,GA,7314,23960,229,A,31274,2775,667,3442,0.193782684
20200406,GU,113,505,4,0,618,12,1,13,0.076923077
20200406,HI,371,13155,4,A,13526,551,20,571,0.03502627
20200406,IA,946,10653,25,A,11599,680,78,758,0.102902375
20200406,ID,1101,9894,10,A,10995,710,24,734,0.032697548
20200406,IL,12262,50680,307,A,62942,2953,1006,3959,0.254104572
20200406,IN,4944,21247,139,B,26191,3006,533,3539,0.150607516
20200406,KS,845,8239,25,B,9084,763,98,861,0.113821138
20200406,KY,955,17812,45,A,18767,2066,38,2104,0.018060837
20200406,LA,14867,54299,512,A,69166,6984,1857,8841,0.210044113
20200406,MA,13739,62720,448,B,76459,3155,1337,4492,0.297640249
20200406,MD,4045,25572,91,A,29617,844,436,1280,0.340625
20200406,ME,499,6088,10,A,6587,0,29,29,1
20200406,MI,18850,43120,727,B,61970,2789,1283,4072,0.315078585
20200406,MN,986,27142,30,A,28128,1300,51,1351,0.037749815
20200406,MO,2722,27113,39,A,29835,2231,355,2586,0.137277649
20200406,MP,8,13,1,0,21,0,0,0,0
20200406,MS,1738,18632,51,A,20370,13052,100,13152,0.007603406
20200406,MT,299,6491,6,A,6790,174,13,187,0.069518717
20200406,NC,2870,37856,33,A,40726,396,285,681,0.418502203
20200406,ND,225,6988,3,B,7213,408,18,426,0.042253521
20200406,NE,409,6378,8,A,6787,820,46,866,0.053117783
20200406,NH,669,7701,9,B,8370,290,48,338,0.142011834
20200406,NJ,41090,47942,1003,A,89032,3281,3585,6866,0.522138072
20200406,NM,624,18512,12,A,19136,2227,81,2308,0.035095321
20200406,NV,1953,15676,46,A,17629,681,117,798,0.146616541
20200406,NY,130689,190122,4758,A,320811,9873,8658,18531,0.467217096
20200406,OH,4450,43928,142,B,48378,4215,407,4622,0.088057118
20200406,OK,1327,1422,51,B,2749,21,75,96,0.78125
20200406,OR,1132,20669,27,A,21801,1113,64,1177,0.054375531
20200406,PA,12980,70874,162,A,83854,4613,1470,6083,0.241657077
20200406,PR,513,3432,21,A,3945,359,38,397,0.095717884
20200406,RI,1082,7399,27,B,8481,1140,160,1300,0.123076923
20200406,SC,2049,16927,44,B,18976,0,0,0,0
20200406,SD,288,5732,4,A,6020,379,48,427,0.112412178
20200406,TN,3802,43548,65,A,47350,1881,169,2050,0.082439024
20200406,TX,7276,78081,140,A,85357,13955,464,14419,0.032179763
20200406,UT,1675,31719,13,A,33394,2432,70,2502,0.027977618
20200406,VA,2878,21643,54,A,24521,609,241,850,0.283529412
20200406,VI,43,222,1,0,265,16,1,17,0.058823529
20200406,VT,575,6161,23,A,6736,331,32,363,0.08815427
20200406,WA,8937,100203,407,A,109140,4658,393,5051,0.077806375
20200406,WI,2440,26574,77,A,29014,1405,173,1578,0.109632446
20200406,WV,345,9595,4,B,9940,1081,21,1102,0.019056261
20200406,WY,210,3719,0,A,3929,679,13,692,0.018786127
20200405,AK,185,6099,6,A,6284,230,14,244,0.057377049
20200405,AL,1796,11282,45,B,13078,2009,216,2225,0.097078652
20200405,AR,830,10412,16,A,11242,785,87,872,0.099770642
20200405,AS,0,3,0,0,3,0,0,0,0
20200405,AZ,2269,25141,64,B,27410,0,250,250,1
20200405,CA,13438,103095,319,B,116533,1421,1412,2833,0.498411578
20200405,CO,4565,19335,126,A,23900,1437,392,1829,0.214324768
20200405,CT,5675,17595,189,A,23270,842,399,1241,0.321514907
20200405,DC,998,5836,22,A,6834,300,96,396,0.242424242
20200405,DE,673,6321,14,C,6994,447,80,527,0.151802657
20200405,FL,12151,101253,218,A,113404,10297,1040,11337,0.091735027
20200405,GA,6647,21185,211,A,27832,1051,487,1538,0.316644993
20200405,GU,112,493,4,0,605,21,19,40,0.475
20200405,HI,351,12604,4,A,12955,645,32,677,0.047267356
20200405,IA,868,9973,22,C,10841,519,82,601,0.136439268
20200405,ID,1077,9184,10,A,10261,1327,64,1391,0.046010065
20200405,IL,11256,47727,274,A,58983,4503,899,5402,0.166419845
20200405,IN,4411,18241,127,B,22652,2394,458,2852,0.16058906
20200405,KS,747,7476,22,B,8223,596,49,645,0.075968992
20200405,KY,917,15746,40,A,16663,1005,86,1091,0.078826764
20200405,LA,13010,47315,477,A,60325,1313,514,1827,0.281335523
20200405,MA,12402,59565,370,B,71967,2374,765,3139,0.243708187
20200405,MD,3609,24728,67,A,28337,2243,484,2727,0.177484415
20200405,ME,470,6088,10,A,6558,0,14,14,1
20200405,MI,17567,40331,617,B,57898,2926,1172,4098,0.285993167
20200405,MN,935,25842,29,A,26777,1284,70,1354,0.051698671
20200405,MO,2367,24882,34,C,27249,2268,76,2344,0.032423208
20200405,MP,8,13,1,0,21,0,0,0,0
20200405,MS,1638,5580,43,B,7218,447,183,630,0.29047619
20200405,MT,286,6317,6,A,6603,405,21,426,0.049295775
20200405,NC,2585,37460,31,A,40045,1089,183,1272,0.143867925
20200405,ND,207,6580,3,B,6787,559,21,580,0.036206897
20200405,NE,363,5558,8,A,5921,500,42,542,0.077490775
20200405,NH,621,7411,9,B,8032,446,81,527,0.15370019
20200405,NJ,37505,44661,917,A,82166,3429,3381,6810,0.496475771
20200405,NM,543,16285,11,A,16828,1148,48,1196,0.040133779
20200405,NV,1836,14995,46,A,16831,574,94,668,0.140718563
20200405,NY,122031,180249,4159,A,302280,10332,8327,18659,0.446272576
20200405,OH,4043,39713,119,B,43756,1581,304,1885,0.16127321
20200405,OK,1252,1401,46,B,2653,39,93,132,0.704545455
20200405,OR,1068,19556,27,A,20624,3021,69,3090,0.022330097
20200405,PA,11510,66261,150,A,77771,6248,1493,7741,0.192869138
20200405,PR,475,3073,20,A,3548,468,23,491,0.046843177
20200405,RI,922,6259,25,B,7181,675,116,791,0.14664981
20200405,SC,2049,16927,44,B,18976,530,132,662,0.19939577
20200405,SD,240,5353,2,A,5593,341,28,369,0.075880759
20200405,TN,3633,41667,44,A,45300,3597,312,3909,0.07981581
20200405,TX,6812,64126,127,A,70938,6485,702,7187,0.09767636
20200405,UT,1605,29287,8,A,30892,2672,177,2849,0.062127062
20200405,VA,2637,21034,51,A,23671,1889,230,2119,0.108541765
20200405,VI,42,206,1,0,248,22,2,24,0.083333333
20200405,VT,543,5830,22,A,6373,588,31,619,0.050080775
20200405,WA,8544,95545,386,A,104089,1773,169,1942,0.087023687
20200405,WI,2267,25169,68,A,27436,1310,155,1465,0.105802048
20200405,WV,324,8514,3,B,8838,1110,42,1152,0.036458333
20200405,WY,197,3040,0,A,3237,95,10,105,0.095238095
20200404,AK,171,5869,5,A,6040,10,14,24,0.583333333
20200404,AL,1580,9273,43,B,10853,1086,148,1234,0.11993517
20200404,AR,743,9627,14,A,10370,632,39,671,0.058122206
20200404,AS,0,3,0,0,3,0,0,0,0
20200404,AZ,2019,25141,52,B,27160,2237,250,2487,0.100522718
20200404,CA,12026,101674,276,B,113700,77075,1325,78400,0.01690051
20200404,CO,4173,17898,111,A,22071,1215,445,1660,0.268072289
20200404,CT,5276,16753,165,A,22029,1652,362,2014,0.179741807
20200404,DC,902,5536,21,A,6438,709,145,854,0.169789227
20200404,DE,593,5874,14,C,6467,879,143,1022,0.139921722
20200404,FL,11111,90956,191,A,102067,8819,1526,10345,0.147510875
20200404,GA,6160,20134,201,A,26294,700,329,1029,0.319727891
20200404,GU,93,472,4,0,565,13,9,22,0.409090909
20200404,HI,319,11959,3,A,12278,1753,34,1787,0.019026301
20200404,IA,786,9454,14,C,10240,700,87,787,0.110546379
20200404,ID,1013,7857,10,A,8870,803,122,925,0.131891892
20200404,IL,10357,43224,243,A,53581,4080,1453,5533,0.262606181
20200404,IN,3953,15847,116,B,19800,1449,516,1965,0.26259542
20200404,KS,698,6880,21,B,7578,426,78,504,0.154761905
20200404,KY,831,14741,37,A,15572,2707,61,2768,0.022037572
20200404,LA,12496,46002,409,A,58498,2654,2199,4853,0.45312178
20200404,MA,11637,57191,304,B,68828,4506,1334,5840,0.228424658
20200404,MD,3125,22485,53,A,25610,1553,367,1920,0.191145833
20200404,ME,456,6088,10,A,6544,0,24,24,1
20200404,MI,16395,37405,540,B,53800,3735,1143,4878,0.234317343
20200404,MN,865,24558,24,A,25423,1120,76,1196,0.063545151
20200404,MO,2291,22614,24,C,24905,3257,178,3435,0.051819505
20200404,MP,8,13,1,0,21,0,0,0,0
20200404,MS,1455,5133,35,B,6588,380,97,477,0.203354298
20200404,MT,265,5912,5,A,6177,579,22,601,0.036605657
20200404,NC,2402,36371,24,A,38773,6866,309,7175,0.043066202
20200404,ND,186,6021,3,B,6207,396,13,409,0.031784841
20200404,NE,321,5058,6,A,5379,571,42,613,0.068515498
20200404,NH,540,6965,7,B,7505,390,61,451,0.135254989
20200404,NJ,34124,41232,846,A,75356,3624,4229,7853,0.538520311
20200404,NM,495,15137,10,A,15632,762,92,854,0.107728337
20200404,NV,1742,14421,46,A,16163,1403,228,1631,0.139791539
20200404,NY,113704,169917,3565,A,283621,12260,10841,23101,0.469287044
20200404,OH,3739,38132,102,B,41871,3069,427,3496,0.122139588
20200404,OK,1159,1362,42,B,2521,47,171,218,0.78440367
20200404,OR,999,16535,26,A,17534,0,100,100,1
20200404,PA,10017,60013,136,A,70030,6318,1597,7915,0.201768793
20200404,PR,452,2605,18,A,3057,556,74,630,0.117460317
20200404,RI,806,5584,17,B,6390,727,97,824,0.117718447
20200404,SC,1917,16397,40,B,18314,10956,363,11319,0.032069971
20200404,SD,212,5012,2,A,5224,419,25,444,0.056306306
20200404,TN,3321,38070,43,A,41391,3298,254,3552,0.071509009
20200404,TX,6110,57641,105,A,63751,7207,780,7987,0.097658695
20200404,UT,1428,26615,8,A,28043,3613,182,3795,0.047957839
20200404,VA,2407,19145,52,A,21552,2152,395,2547,0.155084413
20200404,VI,40,184,0,0,224,30,2,32,0.0625
20200404,VT,512,5242,20,A,5754,377,52,429,0.121212121
20200404,WA,8375,93772,365,A,102147,2374,208,2582,0.080557707
20200404,WI,2112,23859,56,A,25971,1482,200,1682,0.118906064
20200404,WV,282,7404,2,B,7686,1274,45,1319,0.034116755
20200404,WY,187,2945,0,A,3132,241,25,266,0.093984962
20200403,AK,157,5859,3,A,6016,980,14,994,0.014084507
20200403,AL,1432,8187,35,B,9619,684,199,883,0.225368063
20200403,AR,704,8995,12,A,9699,1115,61,1176,0.051870748
20200403,AS,0,3,0,0,3,0,0,0,0
20200403,AZ,1769,22904,41,B,24673,1793,171,1964,0.08706721
20200403,CA,10701,24599,237,B,35300,790,1510,2300,0.656521739
20200403,CO,3728,16683,97,A,20411,1380,386,1766,0.218573046
20200403,CT,4914,15101,131,A,20015,625,1090,1715,0.635568513
20200403,DC,757,4827,15,A,5584,410,104,514,0.20233463
20200403,DE,450,4995,14,C,5445,429,57,486,0.117283951
20200403,FL,9585,82137,163,A,91722,12851,1575,14426,0.109177873
20200403,GA,5831,19434,184,A,25265,1825,483,2308,0.209272097
20200403,GU,84,459,4,0,543,17,2,19,0.105263158
20200403,HI,285,10206,2,A,10491,0,27,27,1
20200403,IA,699,8754,11,C,9453,700,85,785,0.108280255
20200403,ID,891,7054,9,A,7945,441,222,663,0.334841629
20200403,IL,8904,39144,210,A,48048,3183,1209,4392,0.275273224
20200403,IN,3437,14398,102,B,17835,1152,398,1550,0.256774194
20200403,KS,620,6454,17,B,7074,395,68,463,0.146868251
20200403,KY,770,12034,31,A,12804,4814,90,4904,0.018352365
20200403,LA,10297,43348,370,A,53645,1412,1147,2559,0.448221962
20200403,MA,10303,52685,265,B,62988,4918,1436,6354,0.22599937
20200403,MD,2758,20932,42,A,23690,2042,427,2469,0.172944512
20200403,ME,432,6088,9,A,6520,0,56,56,1
20200403,MI,15252,33670,479,B,48922,3302,1135,4437,0.255803471
20200403,MN,789,23438,22,A,24227,1786,47,1833,0.025641026
20200403,MO,2113,19357,19,C,21470,1508,279,1787,0.156127588
20200403,MP,8,13,1,0,21,0,0,0,0
20200403,MS,1358,4753,29,B,6111,0,181,181,1
20200403,MT,243,5333,5,A,5576,240,16,256,0.0625
20200403,NC,2093,29505,19,A,31598,2683,236,2919,0.080849606
20200403,ND,173,5625,3,B,5798,804,14,818,0.017114914
20200403,NE,279,4487,6,A,4766,509,33,542,0.060885609
20200403,NH,479,6575,5,B,7054,497,64,561,0.114081996
20200403,NJ,29895,37608,646,A,67503,4088,4305,8393,0.51292744
20200403,NM,403,14375,7,A,14778,727,40,767,0.052151239
20200403,NV,1514,13018,43,A,14532,430,56,486,0.115226337
20200403,NY,102863,157657,2935,A,260520,11073,10482,21555,0.486290884
20200403,OH,3312,35063,91,B,38375,3047,410,3457,0.118599942
20200403,OK,988,1315,38,B,2303,50,109,159,0.685534591
20200403,OR,899,16535,22,A,17434,1276,73,1349,0.054114159
20200403,PA,8420,53695,102,A,62115,5997,1404,7401,0.189704094
20200403,PR,378,2049,15,A,2427,445,62,507,0.122287968
20200403,RI,709,4857,14,B,5566,445,52,497,0.104627767
20200403,SC,1554,5441,31,B,6995,0,0,0,0
20200403,SD,187,4593,2,A,4780,376,22,398,0.055276382
20200403,TN,3067,34772,37,A,37839,3006,222,3228,0.068773234
20200403,TX,5330,50434,90,A,55764,4424,661,5085,0.129990167
20200403,UT,1246,23002,7,A,24248,2847,172,3019,0.056972507
20200403,VA,2012,16993,46,A,19005,1110,306,1416,0.216101695
20200403,VI,38,154,0,0,192,5,5,10,0.5
20200403,VT,460,4865,17,A,5325,481,70,551,0.127041742
20200403,WA,8167,91398,338,A,99565,4361,409,4770,0.085744235
20200403,WI,1912,22377,37,A,24289,2060,182,2242,0.08117752
20200403,WV,237,6130,2,B,6367,854,20,874,0.022883295
20200403,WY,162,2704,0,A,2866,265,12,277,0.0433213
20200402,AK,143,4879,3,A,5022,409,10,419,0.023866348
20200402,AL,1233,7503,32,B,8736,806,156,962,0.162162162
20200402,AR,643,7880,12,A,8523,526,59,585,0.100854701
20200402,AS,0,3,0,0,3,0,0,0,0
20200402,AZ,1598,21111,32,B,22709,1466,185,1651,0.112053301
20200402,CA,9191,23809,203,B,33000,2037,1036,3073,0.337129841
20200402,CO,3342,15303,80,A,18645,1420,376,1796,0.20935412
20200402,CT,3824,14476,112,A,18300,1433,267,1700,0.157058824
20200402,DC,653,4417,12,A,5070,1155,67,1222,0.054828151
20200402,DE,393,4566,12,C,4959,551,25,576,0.043402778
20200402,FL,8010,69286,128,A,77296,9757,1055,10812,0.097576767
20200402,GA,5348,17609,163,A,22957,1921,710,2631,0.269859369
20200402,GU,82,442,3,0,524,36,5,41,0.12195122
20200402,HI,258,10206,1,A,10464,1485,50,1535,0.03257329
20200402,IA,614,8054,11,C,8668,750,65,815,0.079754601
20200402,ID,669,6613,9,A,7282,537,144,681,0.211453744
20200402,IL,7695,35961,157,A,43656,2557,715,3272,0.218520782
20200402,IN,3039,13246,78,B,16285,1436,474,1910,0.248167539
20200402,KS,552,6059,13,B,6611,648,70,718,0.097493036
20200402,KY,680,7220,20,A,7900,255,89,344,0.25872093
20200402,LA,9150,41936,310,A,51086,2584,2726,5310,0.513370998
20200402,MA,8867,47767,229,B,56634,3642,1228,4870,0.252156057
20200402,MD,2331,18890,36,A,21221,1657,346,2003,0.172740889
20200402,ME,376,6088,7,A,6464,0,32,32,1
20200402,MI,14117,30368,417,B,44485,3131,1229,4360,0.281880734
20200402,MN,742,21652,18,A,22394,1150,53,1203,0.044056525
20200402,MO,1834,17849,19,C,19683,2003,253,2256,0.11214539
20200402,MP,8,13,1,0,21,13,2,15,0.133333333
20200402,MS,1177,4753,26,B,5930,1041,104,1145,0.090829694
20200402,MT,227,5093,5,A,5320,383,19,402,0.047263682
20200402,NC,1857,26822,16,A,28679,2163,273,2436,0.112068966
20200402,ND,159,4821,3,B,4980,470,17,487,0.034907598
20200402,NE,246,3978,5,A,4224,503,36,539,0.066790353
20200402,NH,415,6078,4,B,6493,93,0,93,0
20200402,NJ,25590,33520,537,A,59110,3133,3335,6468,0.515615337
20200402,NM,363,13648,6,A,14011,723,48,771,0.062256809
20200402,NV,1458,12588,38,A,14046,1069,179,1248,0.143429487
20200402,NY,92381,146584,2373,A,238965,9416,8669,18085,0.479347526
20200402,OH,2902,32016,81,B,34918,5024,355,5379,0.065997397
20200402,OK,879,1265,34,B,2144,17,160,177,0.903954802
20200402,OR,826,15259,21,A,16085,2123,90,2213,0.040668775
20200402,PA,7016,47698,90,A,54714,5271,1211,6482,0.186825054
20200402,PR,316,1604,12,A,1920,195,30,225,0.133333333
20200402,RI,657,4412,12,B,5069,581,91,672,0.135416667
20200402,SC,1554,5441,31,B,6995,408,261,669,0.390134529
20200402,SD,165,4217,2,A,4382,314,36,350,0.102857143
20200402,TN,2845,31766,32,A,34611,1997,162,2159,0.075034738
20200402,TX,4669,46010,70,A,50679,2150,672,2822,0.238128987
20200402,UT,1074,20155,7,A,21229,0,62,62,1
20200402,VA,1706,15883,41,A,17589,2023,222,2245,0.098886414
20200402,VI,33,149,0,0,182,23,3,26,0.115384615
20200402,VT,390,4384,17,A,4774,222,31,253,0.122529644
20200402,WA,7758,87037,310,A,94795,4422,404,4826,0.08371322
20200402,WI,1730,20317,31,A,22047,1498,180,1678,0.10727056
20200402,WV,217,5276,2,B,5493,892,26,918,0.02832244
20200402,WY,150,2439,0,A,2589,221,20,241,0.082987552
20200401,AK,133,4470,3,A,4603,876,14,890,0.015730337
20200401,AL,1077,6697,26,B,7774,399,96,495,0.193939394
20200401,AR,584,7354,10,A,7938,1395,61,1456,0.041895604
20200401,AS,0,3,0,0,3,0,0,0,0
20200401,AZ,1413,19645,29,B,21058,1563,124,1687,0.07350326
20200401,CA,8155,21772,171,B,29927,0,673,673,1
20200401,CO,2966,13883,69,A,16849,1146,339,1485,0.228282828
20200401,CT,3557,13043,85,A,16600,14,429,443,0.968397291
20200401,DC,586,3262,11,A,3848,0,91,91,1
20200401,DE,368,4015,11,C,4383,319,49,368,0.133152174
20200401,FL,6955,59529,87,A,66484,5244,617,5861,0.105272138
20200401,GA,4638,15688,139,A,20326,3436,709,4145,0.171049457
20200401,GU,77,406,3,0,483,35,8,43,0.186046512
20200401,HI,208,8721,1,A,8929,250,4,254,0.015748031
20200401,IA,549,7304,9,C,7853,416,52,468,0.111111111
20200401,ID,525,6076,9,A,6601,779,110,889,0.123734533
20200401,IL,6980,33404,141,A,40384,4173,986,5159,0.191122311
20200401,IN,2565,11810,65,B,14375,596,406,1002,0.405189621
20200401,KS,482,5411,10,B,5893,415,54,469,0.115138593
20200401,KY,591,6965,17,A,7556,635,111,746,0.148793566
20200401,LA,6424,39352,273,A,45776,5622,1187,6809,0.174328095
20200401,MA,7639,44125,187,B,51764,3685,1118,4803,0.232771185
20200401,MD,1985,17233,31,A,19218,2365,325,2690,0.120817844
20200401,ME,344,6088,7,A,6432,0,41,41,1
20200401,MI,12888,27237,337,B,40125,3258,1013,4271,0.237180988
20200401,MN,689,20502,17,A,21191,1351,60,1411,0.042523033
20200401,MO,1581,15846,18,C,17427,1232,254,1486,0.170928668
20200401,MP,6,0,0,0,6,0,4,4,1
20200401,MS,1073,3712,22,B,4785,175,136,311,0.437299035
20200401,MT,208,4710,5,A,4918,476,24,500,0.048
20200401,NC,1584,24659,10,A,26243,3051,86,3137,0.027414727
20200401,ND,142,4351,3,B,4493,220,16,236,0.06779661
20200401,NE,210,3475,4,A,3685,544,38,582,0.065292096
20200401,NH,415,5985,4,B,6400,572,101,673,0.150074294
20200401,NJ,22255,30387,355,A,52642,3310,3559,6869,0.518124909
20200401,NM,315,12925,5,A,13240,679,34,713,0.047685835
20200401,NV,1279,11519,26,A,12798,838,166,1004,0.165338645
20200401,NY,83712,137168,1941,A,220880,7777,7917,15694,0.504460303
20200401,OH,2547,26992,65,B,29539,0,348,348,1
20200401,OK,719,1248,30,B,1967,19,154,173,0.89017341
20200401,OR,736,13136,18,A,13872,0,46,46,1
20200401,PA,5805,42427,74,A,48232,4782,962,5744,0.167479109
20200401,PR,286,1409,11,A,1695,214,47,261,0.180076628
20200401,RI,566,3831,10,B,4397,355,77,432,0.178240741
20200401,SC,1293,5033,26,B,6326,417,210,627,0.33492823
20200401,SD,129,3903,2,A,4032,294,21,315,0.066666667
20200401,TN,2683,29769,24,A,32452,4648,444,5092,0.087195601
20200401,TX,3997,43860,58,A,47857,4134,731,4865,0.150256937
20200401,UT,1012,20155,7,A,21167,2529,125,2654,0.047098719
20200401,VA,1484,13860,34,A,15344,1709,234,1943,0.120432321
20200401,VI,30,126,0,0,156,0,0,0,0
20200401,VT,359,4162,16,A,4521,213,39,252,0.154761905
20200401,WA,7354,82615,282,A,89969,4212,446,4658,0.095749249
20200401,WI,1550,18819,24,A,20369,1444,199,1643,0.121119903
20200401,WV,191,4384,1,B,4575,403,29,432,0.06712963
20200401,WY,130,2218,0,A,2348,219,21,240,0.0875
20200331,AK,119,3594,3,A,3713,54,5,59,0.084745763
20200331,AL,981,6298,13,B,7279,604,122,726,0.168044077
20200331,AR,523,5959,8,A,6482,697,50,747,0.066934404
20200331,AS,0,3,0,0,3,3,0,3,0
20200331,AZ,1289,18082,24,B,19371,2480,132,2612,0.050535988
20200331,CA,7482,21772,153,B,29254,1223,1035,2258,0.458370239
20200331,CO,2627,12737,51,A,15364,0,0,0,0
20200331,CT,3128,13029,69,A,16157,1000,557,1557,0.357739242
20200331,DC,495,3262,9,A,3757,580,94,674,0.139465875
20200331,DE,319,3696,10,C,4015,1480,55,1535,0.035830619
20200331,FL,6338,54285,77,A,60623,6060,865,6925,0.124909747
20200331,GA,3929,12252,111,A,16181,2337,1120,3457,0.32398033
20200331,GU,69,371,2,0,440,19,11,30,0.366666667
20200331,HI,204,8471,0,A,8675,646,29,675,0.042962963
20200331,IA,497,6888,7,C,7385,726,73,799,0.091364205
20200331,ID,415,5297,7,A,5712,901,105,1006,0.104373757
20200331,IL,5994,29231,99,A,35225,3842,937,4779,0.196066123
20200331,IN,2159,11214,49,B,13373,1342,373,1715,0.217492711
20200331,KS,428,4996,9,B,5424,442,60,502,0.119521912
20200331,KY,480,6330,11,A,6810,751,41,792,0.051767677
20200331,LA,5237,33730,239,A,38967,3722,1212,4934,0.245642481
20200331,MA,6521,40440,153,B,46961,3274,868,4142,0.209560599
20200331,MD,1660,14868,18,A,16528,1552,247,1799,0.137298499
20200331,ME,303,6088,5,A,6391,2694,28,2722,0.010286554
20200331,MI,11875,23979,259,B,35854,2796,974,3770,0.258355438
20200331,MN,629,19151,12,A,19780,905,53,958,0.055323591
20200331,MO,1327,14614,14,C,15941,1410,296,1706,0.173505275
20200331,MP,2,0,0,0,2,0,0,0,0
20200331,MS,937,3537,20,B,4474,548,90,638,0.141065831
20200331,MT,184,4234,4,A,4418,91,13,104,0.125
20200331,NC,1498,21608,8,A,23106,2051,191,2242,0.085191793
20200331,ND,126,4131,3,B,4257,403,17,420,0.04047619
20200331,NE,172,2931,3,A,3103,347,27,374,0.072192513
20200331,NH,314,5413,3,B,5727,27,0,27,0
20200331,NJ,18696,27077,267,A,45773,1853,2060,3913,0.526450294
20200331,NM,281,12246,4,A,12527,1304,44,1348,0.03264095
20200331,NV,1113,10681,17,A,11794,474,105,579,0.18134715
20200331,NY,75795,129391,1550,A,205186,9420,9298,18718,0.496741105
20200331,OH,2199,26992,55,B,29191,1650,266,1916,0.138830898
20200331,OK,565,1229,23,B,1794,22,84,106,0.79245283
20200331,OR,690,13136,18,A,13826,859,84,943,0.089077413
20200331,PA,4843,37645,63,A,42488,3868,756,4624,0.16349481
20200331,PR,239,1195,8,A,1434,264,65,329,0.197568389
20200331,RI,489,3476,8,B,3965,289,87,376,0.231382979
20200331,SC,1083,4616,22,B,5699,456,158,614,0.25732899
20200331,SD,108,3609,1,A,3717,131,7,138,0.050724638
20200331,TN,2239,25121,23,A,27360,3651,405,4056,0.099852071
20200331,TX,3266,39726,41,A,42992,6723,389,7112,0.054696288
20200331,UT,887,17626,5,A,18513,2429,81,2510,0.032270916
20200331,VA,1250,12151,27,A,13401,1133,230,1363,0.168745415
20200331,VI,30,126,0,0,156,0,0,0,0
20200331,VT,320,3949,13,A,4269,231,27,258,0.104651163
20200331,WA,6908,78403,262,A,85311,4158,467,4625,0.100972973
20200331,WI,1351,17375,16,A,18726,1519,130,1649,0.078835658
20200331,WV,162,3981,1,B,4143,997,36,1033,0.034849952
20200331,WY,109,1999,0,A,2108,159,15,174,0.086206897
20200330,AK,114,3540,3,A,3654,308,12,320,0.0375
20200330,AL,859,5694,6,B,6553,1510,53,1563,0.033909149
20200330,AR,473,5262,7,A,5735,2235,47,2282,0.020595968
20200330,AS,0,0,0,0,0,0,0,0,0
20200330,AZ,1157,15602,20,B,16759,2649,238,2887,0.082438517
20200330,CA,6447,20549,133,B,26996,0,739,739,1
20200330,CO,2627,12737,51,A,15364,1522,566,2088,0.271072797
20200330,CT,2571,12029,36,A,14600,2122,578,2700,0.214074074
20200330,DC,401,2682,9,A,3083,213,59,272,0.216911765
20200330,DE,264,2216,6,C,2480,2180,32,2212,0.014466546
20200330,FL,5473,48225,63,A,53698,9155,1227,10382,0.118185321
20200330,GA,2809,9915,87,A,12724,2,158,160,0.9875
20200330,GU,58,352,1,0,410,18,2,20,0.1
20200330,HI,175,7825,0,A,8000,976,24,1000,0.024
20200330,IA,424,6162,6,C,6586,1149,88,1237,0.071139854
20200330,ID,310,4396,6,A,4706,375,49,424,0.115566038
20200330,IL,5057,25389,73,A,30446,2223,461,2684,0.171758569
20200330,IN,1786,9872,35,B,11658,1556,272,1828,0.148796499
20200330,KS,368,4554,8,B,4922,360,49,409,0.119804401
20200330,KY,439,5579,9,A,6018,432,45,477,0.094339623
20200330,LA,4025,30008,185,A,34033,5677,485,6162,0.078708212
20200330,MA,5653,37166,124,B,42819,2932,797,3729,0.213730223
20200330,MD,1413,13316,15,A,14729,962,174,1136,0.153169014
20200330,ME,275,3394,3,A,3669,0,22,22,1
20200330,MI,10901,21183,184,B,32084,5507,891,6398,0.139262269
20200330,MN,576,18246,10,A,18822,1092,73,1165,0.062660944
20200330,MO,1031,13204,13,C,14235,1657,193,1850,0.104324324
20200330,MP,2,0,0,0,2,0,0,0,0
20200330,MS,847,2989,16,B,3836,429,89,518,0.171814672
20200330,MT,171,4143,4,A,4314,0,17,17,1
20200330,NC,1307,19557,6,A,20864,1652,267,1919,0.139134966
20200330,ND,109,3728,2,B,3837,373,11,384,0.028645833
20200330,NE,145,2584,2,A,2729,616,37,653,0.056661562
20200330,NH,314,5386,3,B,5700,862,100,962,0.103950104
20200330,NJ,16636,25224,198,A,41860,3008,3250,6258,0.519335251
20200330,NM,237,10942,2,A,11179,173,0,173,0
20200330,NV,1008,10207,15,A,11215,1795,270,2065,0.130750605
20200330,NY,66497,119971,1218,A,186468,7124,6984,14108,0.495038276
20200330,OH,1933,25342,39,B,27275,6330,280,6610,0.042360061
20200330,OK,481,1207,17,B,1688,2,52,54,0.962962963
20200330,OR,606,12277,16,A,12883,1399,58,1457,0.039807824
20200330,PA,4087,33777,49,A,37864,3716,693,4409,0.157178499
20200330,PR,174,931,6,A,1105,90,47,137,0.343065693
20200330,RI,402,3187,4,B,3589,347,108,455,0.237362637
20200330,SC,925,4160,18,B,5085,1145,151,1296,0.116512346
20200330,SD,101,3478,1,A,3579,351,11,362,0.03038674
20200330,TN,1834,21470,13,A,23304,2433,297,2730,0.108791209
20200330,TX,2877,33003,34,A,35880,9795,325,10120,0.032114625
20200330,UT,806,15197,4,A,16003,1923,87,2010,0.043283582
20200330,VA,1020,11018,25,A,12038,1299,130,1429,0.090972708
20200330,VI,30,126,0,0,156,3,7,10,0.7
20200330,VT,293,3718,12,A,4011,235,37,272,0.136029412
20200330,WA,6441,74245,248,A,80686,4495,561,5056,0.110957278
20200330,WI,1221,15856,14,A,17077,-694,109,-585,-0.186324786
20200330,WV,126,2984,1,B,3110,279,13,292,0.044520548
20200330,WY,94,1840,0,A,1934,286,8,294,0.027210884
20200329,AK,102,3232,2,A,3334,396,17,413,0.041162228
20200329,AL,806,4184,4,B,4990,0,110,110,1
20200329,AR,426,3027,6,A,3453,89,22,111,0.198198198
20200329,AS,0,0,0,0,0,0,0,0,0
20200329,AZ,919,12953,17,B,13872,5498,46,5544,0.008297258
20200329,CA,5708,20549,123,B,26257,0,1065,1065,1
20200329,CO,2061,11215,44,A,13276,1273,327,1600,0.204375
20200329,CT,1993,9907,34,A,11900,2798,702,3500,0.200571429
20200329,DC,342,2469,5,A,2811,258,38,296,0.128378378
20200329,DE,232,36,6,C,268,0,18,18,1
20200329,FL,4246,39070,56,A,43316,3704,483,4187,0.115357058
20200329,GA,2651,9913,80,A,12564,1228,285,1513,0.188367482
20200329,GU,56,334,1,0,390,35,1,36,0.027777778
20200329,HI,151,6849,0,A,7000,2492,31,2523,0.01228696
20200329,IA,336,5013,4,C,5349,638,38,676,0.056213018
20200329,ID,261,4021,5,A,4282,679,31,710,0.043661972
20200329,IL,4596,23166,65,A,27762,1166,1105,2271,0.486569793
20200329,IN,1514,8316,32,B,9830,1141,282,1423,0.198172874
20200329,KS,319,4194,6,B,4513,523,58,581,0.099827883
20200329,KY,394,5147,9,A,5541,326,92,418,0.220095694
20200329,LA,3540,24331,151,A,27871,2485,225,2710,0.08302583
20200329,MA,4856,34234,99,B,39090,3319,698,4017,0.173761514
20200329,MD,1239,12354,10,D,13593,838,247,1085,0.22764977
20200329,ME,253,3394,3,A,3647,0,42,42,1
20200329,MI,10010,15676,132,B,25686,1493,723,2216,0.326263538
20200329,MN,503,17154,9,A,17657,1466,62,1528,0.040575916
20200329,MO,838,11547,10,C,12385,1465,0,1465,0
20200329,MP,2,0,0,0,2,0,0,0,0
20200329,MS,758,2560,14,B,3318,0,95,95,1
20200329,MT,154,4143,1,A,4297,887,25,912,0.027412281
20200329,NC,1040,17905,4,A,18945,1313,105,1418,0.074047955
20200329,ND,98,3355,1,B,3453,546,15,561,0.026737968
20200329,NE,108,1968,2,A,2076,64,12,76,0.157894737
20200329,NH,214,4524,2,B,4738,868,27,895,0.030167598
20200329,NJ,13386,22216,161,A,35602,2830,2262,5092,0.444226237
20200329,NM,237,10769,2,A,11006,1573,46,1619,0.0284126
20200329,NV,738,8412,14,A,9150,511,117,628,0.186305732
20200329,NY,59513,112847,965,A,172360,9231,7195,16426,0.438025082
20200329,OH,1653,19012,29,B,20665,0,247,247,1
20200329,OK,429,1205,16,A,1634,25,52,77,0.675324675
20200329,OR,548,10878,13,A,11426,1185,69,1254,0.055023923
20200329,PA,3394,30061,38,A,33455,4807,643,5450,0.117981651
20200329,PR,127,841,5,A,968,102,27,129,0.209302326
20200329,RI,294,2840,3,B,3134,299,55,354,0.155367232
20200329,SC,774,3015,16,B,3789,607,235,842,0.279097387
20200329,SD,90,3127,1,A,3217,535,22,557,0.039497307
20200329,TN,1537,19037,7,A,20574,2072,164,2236,0.073345259
20200329,TX,2552,23208,34,A,25760,0,500,500,1
20200329,UT,719,13274,2,A,13993,2564,117,2681,0.043640433
20200329,VA,890,9719,22,A,10609,1292,151,1443,0.104643105
20200329,VI,23,123,0,0,146,17,1,18,0.055555556
20200329,VT,256,3483,12,A,3739,291,22,313,0.07028754
20200329,WA,5880,69750,237,A,75630,1587,238,1825,0.130410959
20200329,WI,1112,16550,13,A,17662,1318,123,1441,0.085357391
20200329,WV,113,2705,0,B,2818,374,17,391,0.043478261
20200329,WY,86,1554,0,A,1640,79,4,83,0.048192771
20200328,AK,85,2836,2,A,2921,517,16,533,0.030018762
20200328,AL,696,4184,3,B,4880,0,109,109,1
20200328,AR,404,2938,5,A,3342,1393,23,1416,0.016242938
20200328,AS,0,0,0,0,0,0,0,0,0
20200328,AZ,873,7455,15,B,8328,0,137,137,1
20200328,CA,4643,20549,101,B,25192,3169,764,3933,0.19425375
20200328,CO,1734,9942,31,A,11676,1250,304,1554,0.195624196
20200328,CT,1291,7109,27,A,8400,0,0,0,0
20200328,DC,304,2211,4,A,2515,314,37,351,0.105413105
20200328,DE,214,36,3,C,250,0,51,51,1
20200328,FL,3763,35366,54,A,39129,7180,998,8178,0.122034727
20200328,GA,2366,8685,69,A,11051,821,365,1186,0.307757167
20200328,GU,55,299,1,0,354,0,4,4,1
20200328,HI,120,4357,0,A,4477,0,14,14,1
20200328,IA,298,4375,3,C,4673,635,63,698,0.09025788
20200328,ID,230,3342,4,A,3572,674,41,715,0.057342657
20200328,IL,3491,22000,47,A,25491,3484,465,3949,0.117751329
20200328,IN,1232,7175,31,B,8407,1220,251,1471,0.170632223
20200328,KS,261,3671,5,B,3932,442,59,501,0.117764471
20200328,KY,302,4821,8,A,5123,1053,54,1107,0.048780488
20200328,LA,3315,21846,137,A,25161,3233,569,3802,0.149658075
20200328,MA,4158,30915,72,B,35073,4671,1007,5678,0.17735118
20200328,MD,992,11516,5,D,12508,11422,218,11640,0.018728522
20200328,ME,211,3394,1,A,3605,0,43,43,1
20200328,MI,9287,14183,92,B,23470,1544,628,2172,0.289134438
20200328,MN,441,15688,5,A,16129,2083,43,2126,0.020225776
20200328,MO,838,10082,10,C,10920,9713,169,9882,0.017101801
20200328,MP,2,0,0,0,2,0,2,2,1
20200328,MS,663,2560,13,B,3223,0,84,84,1
20200328,MT,129,3256,1,A,3385,666,21,687,0.030567686
20200328,NC,935,16592,4,A,17527,2219,172,2391,0.071936428
20200328,ND,83,2809,1,B,2892,382,18,400,0.045
20200328,NE,96,1904,2,A,2000,143,11,154,0.071428571
20200328,NH,187,3656,2,B,3843,261,29,290,0.1
20200328,NJ,11124,19386,140,A,30510,2839,2299,5138,0.44745037
20200328,NM,191,9196,1,A,9387,819,55,874,0.062929062
20200328,NV,621,7901,10,A,8522,1740,86,1826,0.047097481
20200328,NY,52318,103616,728,A,155934,2498,7683,10181,0.754640998
20200328,OH,1406,19012,25,B,20418,0,269,269,1
20200328,OK,377,1180,15,A,1557,96,55,151,0.364238411
20200328,OR,479,9693,13,A,10172,1183,65,1248,0.052083333
20200328,PA,2751,25254,34,A,28005,4238,533,4771,0.111716621
20200328,PR,100,739,3,A,839,220,21,241,0.087136929
20200328,RI,239,2541,0,B,2780,235,36,271,0.132841328
20200328,SC,539,2408,13,B,2947,101,83,184,0.451086957
20200328,SD,68,2592,1,A,2660,205,10,215,0.046511628
20200328,TN,1373,16965,6,A,18338,2077,170,2247,0.075656431
20200328,TX,2052,23208,27,A,25260,1273,321,1594,0.201380176
20200328,UT,602,10710,2,A,11312,1946,122,2068,0.058994197
20200328,VA,739,8427,17,A,9166,1694,135,1829,0.073810826
20200328,VI,22,106,0,0,128,51,3,54,0.055555556
20200328,VT,234,3192,12,A,3426,324,21,345,0.060869565
20200328,WA,5642,68163,220,A,73805,2319,283,2602,0.10876249
20200328,WI,989,15232,13,A,16221,2092,147,2239,0.06565431
20200328,WV,96,2331,0,B,2427,552,20,572,0.034965035
20200328,WY,82,1475,0,A,1557,264,12,276,0.043478261
20200327,AK,69,2319,1,A,2388,518,10,528,0.018939394
20200327,AL,587,4184,3,B,4771,591,81,672,0.120535714
20200327,AR,381,1545,3,A,1926,41,46,87,0.528735632
20200327,AS,0,0,0,0,0,0,0,0,0
20200327,AZ,736,7455,13,B,8191,7108,159,7267,0.02187973
20200327,CA,3879,17380,78,B,21259,0,873,873,1
20200327,CO,1430,8692,24,A,10122,1714,344,2058,0.167152575
20200327,CT,1291,7109,27,A,8400,1484,279,1763,0.158252978
20200327,DC,267,1897,3,A,2164,271,36,307,0.117263844
20200327,DE,163,36,2,C,199,0,33,33,1
20200327,FL,2765,28186,34,A,30951,4445,410,4855,0.084449022
20200327,GA,2001,7864,64,A,9865,463,476,939,0.506922258
20200327,GU,51,299,1,0,350,36,6,42,0.142857143
20200327,HI,106,4357,0,A,4463,0,11,11,1
20200327,IA,235,3740,3,C,3975,1162,56,1218,0.045977011
20200327,ID,189,2668,3,A,2857,603,66,669,0.098654709
20200327,IL,3026,18516,34,A,21542,4423,488,4911,0.099368764
20200327,IN,981,5955,24,B,6936,1949,336,2285,0.147045952
20200327,KS,202,3229,4,B,3431,360,34,394,0.086294416
20200327,KY,248,3768,6,A,4016,666,50,716,0.069832402
20200327,LA,2746,18613,119,A,21359,2889,441,3330,0.132432432
20200327,MA,3151,26244,57,B,29395,4917,833,5750,0.144869565
20200327,MD,774,94,5,D,868,0,194,194,1
20200327,ME,168,3394,1,A,3562,0,13,13,1
20200327,MI,8659,12639,92,B,21298,2334,892,3226,0.27650341
20200327,MN,398,13605,4,A,14003,1001,52,1053,0.049382716
20200327,MO,669,369,8,C,1038,0,167,167,1
20200327,MP,0,0,0,0,0,0,0,0,0
20200327,MS,579,2560,8,B,3139,269,94,363,0.258953168
20200327,MT,108,2590,0,A,2698,462,37,499,0.074148297
20200327,NC,763,14373,3,A,15136,2099,127,2226,0.05705301
20200327,ND,65,2427,0,B,2492,388,13,401,0.032418953
20200327,NE,85,1761,0,A,1846,177,12,189,0.063492063
20200327,NH,158,3395,1,B,3553,394,21,415,0.05060241
20200327,NJ,8825,16547,108,A,25372,2886,1949,4835,0.403102378
20200327,NM,136,8377,1,A,8513,696,24,720,0.033333333
20200327,NV,535,6161,10,A,6696,1464,115,1579,0.072830906
20200327,NY,44635,101118,519,A,145753,16272,7377,23649,0.31193708
20200327,OH,1137,19012,19,B,20149,2563,270,2833,0.09530533
20200327,OK,322,1084,8,A,1406,126,74,200,0.37
20200327,OR,414,8510,12,A,8924,1557,87,1644,0.052919708
20200327,PA,2218,21016,22,A,23234,4575,531,5106,0.1039953
20200327,PR,79,519,3,A,598,142,15,157,0.095541401
20200327,RI,203,2306,0,B,2509,1044,38,1082,0.035120148
20200327,SC,456,2307,9,B,2763,0,0,0,0
20200327,SD,58,2387,1,A,2445,414,12,426,0.028169014
20200327,TN,1203,14888,6,A,16091,936,246,1182,0.208121827
20200327,TX,1731,21935,23,A,23666,1907,335,2242,0.149420161
20200327,UT,480,8764,2,A,9244,1456,78,1534,0.050847458
20200327,VA,604,6733,14,A,7337,1004,144,1148,0.12543554
20200327,VI,19,55,0,0,74,0,2,2,1
20200327,VT,213,2868,10,A,3081,124,28,152,0.184210526
20200327,WA,5359,65844,199,A,71203,3900,450,4350,0.103448276
20200327,WI,842,13140,13,A,13982,1557,135,1692,0.079787234
20200327,WV,76,1779,0,B,1855,748,25,773,0.032341527
20200327,WY,70,1211,0,A,1281,159,17,176,0.096590909
20200326,AK,59,1801,1,A,1860,152,17,169,0.100591716
20200326,AL,506,3593,1,C,4099,1064,223,1287,0.173271173
20200326,AR,335,1504,3,A,1839,67,55,122,0.450819672
20200326,AS,0,0,0,0,0,0,0,0,0
20200326,AZ,577,347,8,B,924,24,127,151,0.841059603
20200326,CA,3006,17380,65,B,20386,1459,651,2110,0.308530806
20200326,CO,1086,6978,19,A,8064,189,174,363,0.479338843
20200326,CT,1012,5625,21,A,6637,602,137,739,0.185385656
20200326,DC,231,1626,3,A,1857,203,48,251,0.19123506
20200326,DE,130,36,1,C,166,0,15,15,1
20200326,FL,2355,23741,28,A,26096,8367,673,9040,0.074446903
20200326,GA,1525,7401,48,A,8926,2469,278,2747,0.101201311
20200326,GU,45,263,1,0,308,30,8,38,0.210526316
20200326,HI,95,4357,0,A,4452,0,5,5,1
20200326,IA,179,2578,1,C,2757,0,34,34,1
20200326,ID,123,2065,0,A,2188,178,50,228,0.219298246
20200326,IL,2538,14093,26,A,16631,1749,673,2422,0.277869529
20200326,IN,645,4006,17,B,4651,1127,168,1295,0.12972973
20200326,KS,168,2869,3,B,3037,509,42,551,0.076225045
20200326,KY,198,3102,4,A,3300,237,41,278,0.147482014
20200326,LA,2305,15724,83,A,18029,6068,510,6578,0.077531164
20200326,MA,2318,21327,42,B,23645,3248,579,3827,0.151293441
20200326,MD,580,94,4,D,674,0,157,157,1
20200326,ME,155,3394,0,A,3549,217,6,223,0.02690583
20200326,MI,7767,10305,60,D,18072,2768,707,3475,0.203453237
20200326,MN,346,12604,2,A,12950,1416,59,1475,0.04
20200326,MO,502,369,8,C,871,0,146,146,1
20200326,MP,0,0,0,0,0,0,0,0,0
20200326,MS,485,2291,6,B,2776,725,108,833,0.129651861
20200326,MT,71,2128,0,C,2199,180,18,198,0.090909091
20200326,NC,636,12274,2,A,12910,2289,132,2421,0.054522924
20200326,ND,52,2039,0,B,2091,305,13,318,0.040880503
20200326,NE,73,1584,0,A,1657,280,12,292,0.04109589
20200326,NH,137,3001,1,B,3138,645,29,674,0.043026706
20200326,NJ,6876,13661,81,B,20537,3209,2474,5683,0.435333451
20200326,NM,112,7681,1,A,7793,939,12,951,0.012618297
20200326,NV,420,4697,10,A,5117,446,99,545,0.181651376
20200326,NY,37258,84846,385,B,122104,12178,6447,18625,0.346147651
20200326,OH,867,16449,15,B,17316,2389,163,2552,0.063871473
20200326,OK,248,958,7,A,1206,153,84,237,0.35443038
20200326,OR,327,6953,11,A,7280,2603,118,2721,0.043366409
20200326,PA,1687,16441,16,A,18128,5248,560,5808,0.096418733
20200326,PR,64,377,2,A,441,60,13,73,0.178082192
20200326,RI,165,1262,0,B,1427,0,33,33,1
20200326,SC,456,2307,9,B,2763,4,32,36,0.888888889
20200326,SD,46,1973,1,A,2019,1154,5,1159,0.004314064
20200326,TN,957,13952,3,A,14909,2940,173,3113,0.055573402
20200326,TX,1396,20028,18,A,21424,7508,422,7930,0.053215637
20200326,UT,402,7308,1,A,7710,817,56,873,0.064146621
20200326,VA,460,5729,13,A,6189,750,69,819,0.084249084
20200326,VI,17,55,0,0,72,0,0,0,0
20200326,VT,185,2744,9,A,2929,934,25,959,0.026068822
20200326,WA,4909,61944,183,A,66853,4047,432,4479,0.0964501
20200326,WI,707,11583,8,A,12290,1494,122,1616,0.07549505
20200326,WV,51,1031,0,B,1082,272,12,284,0.042253521
20200326,WY,53,1052,0,A,1105,98,9,107,0.08411215
20200325,AK,42,1649,1,A,1691,663,6,669,0.00896861
20200325,AL,283,2529,0,C,2812,423,68,491,0.138492872
20200325,AR,280,1437,2,A,1717,490,62,552,0.112318841
20200325,AS,0,0,0,0,0,0,0,0,0
20200325,AZ,450,323,6,B,773,10,93,103,0.902912621
20200325,CA,2355,15921,53,B,18276,2469,253,2722,0.092946363
20200325,CO,912,6789,11,A,7701,1285,192,1477,0.12999323
20200325,CT,875,5023,19,A,5898,341,257,598,0.429765886
20200325,DC,183,1423,2,A,1606,228,46,274,0.167883212
20200325,DE,115,36,0,C,151,0,24,24,1
20200325,FL,1682,15374,22,A,17056,2247,270,2517,0.10727056
20200325,GA,1247,4932,40,A,6179,474,221,695,0.317985612
20200325,GU,37,233,1,0,270,32,5,37,0.135135135
20200325,HI,90,4357,0,A,4447,768,13,781,0.016645327
20200325,IA,145,2578,1,C,2723,263,21,284,0.073943662
20200325,ID,73,1887,0,A,1960,0,23,23,1
20200325,IL,1865,12344,19,A,14209,2410,330,2740,0.120437956
20200325,IN,477,2879,14,B,3356,313,112,425,0.263529412
20200325,KS,126,2360,3,B,2486,274,28,302,0.092715232
20200325,KY,157,2865,4,A,3022,1103,33,1136,0.029049296
20200325,LA,1795,9656,65,A,11451,2441,407,2848,0.142907303
20200325,MA,1739,18079,33,B,19818,5365,679,6044,0.112342819
20200325,MD,423,94,4,D,517,0,74,74,1
20200325,ME,149,3177,0,A,3326,163,24,187,0.128342246
20200325,MI,7060,7537,43,D,14597,1741,619,2360,0.262288136
20200325,MN,287,11188,1,A,11475,5638,25,5663,0.004414621
20200325,MO,356,369,8,C,725,0,173,173,1
20200325,MP,0,0,0,0,0,0,0,0,0
20200325,MS,377,1566,2,B,1943,14,57,71,0.802816901
20200325,MT,53,1948,0,C,2001,305,7,312,0.022435897
20200325,NC,504,9985,1,A,10489,1844,106,1950,0.054358974
20200325,ND,39,1734,0,B,1773,280,5,285,0.01754386
20200325,NE,61,1304,0,A,1365,329,9,338,0.026627219
20200325,NH,108,2356,1,B,2464,909,7,916,0.007641921
20200325,NJ,4402,10452,62,B,14854,2127,727,2854,0.254730203
20200325,NM,100,6742,1,A,6842,852,17,869,0.019562716
20200325,NV,321,4251,6,A,4572,297,43,340,0.126470588
20200325,NY,30811,72668,285,B,103479,7063,5146,12209,0.421492342
20200325,OH,704,14060,10,B,14764,13920,140,14060,0.009957326
20200325,OK,164,805,5,A,969,70,58,128,0.453125
20200325,OR,209,4350,8,A,4559,0,0,0,0
20200325,PA,1127,11193,11,A,12320,2550,276,2826,0.097664544
20200325,PR,51,317,2,A,368,49,12,61,0.196721311
20200325,RI,132,1262,0,B,1394,62,8,70,0.114285714
20200325,SC,424,2303,7,B,2727,291,126,417,0.302158273
20200325,SD,41,819,1,A,860,29,11,40,0.275
20200325,TN,784,11012,3,A,11796,495,117,612,0.191176471
20200325,TX,974,12520,12,A,13494,1763,564,2327,0.242372153
20200325,UT,346,6491,1,A,6837,967,47,1014,0.046351085
20200325,VA,391,4979,9,A,5370,799,101,900,0.112222222
20200325,VI,17,55,0,0,72,55,0,55,0
20200325,VT,160,1810,8,A,1970,241,35,276,0.126811594
20200325,WA,4477,57897,159,A,62374,4571,439,5010,0.08762475
20200325,WI,585,10089,7,A,10674,1852,128,1980,0.064646465
20200325,WV,39,759,0,B,798,149,19,168,0.113095238
20200325,WY,44,954,0,A,998,244,15,259,0.057915058
20200324,AK,36,986,0,A,1022,40,14,54,0.259259259
20200324,AL,215,2106,0,C,2321,441,48,489,0.098159509
20200324,AR,218,947,0,A,1165,41,44,85,0.517647059
20200324,AS,0,0,0,0,0,0,0,0,0
20200324,AZ,357,313,5,B,670,4,92,96,0.958333333
20200324,CA,2102,13452,40,B,15554,885,369,1254,0.294258373
20200324,CO,720,5504,7,A,6224,659,129,788,0.163705584
20200324,CT,618,4682,12,A,5300,597,203,800,0.25375
20200324,DC,137,1195,2,A,1332,82,21,103,0.203883495
20200324,DE,91,36,0,C,127,0,23,23,1
20200324,FL,1412,13127,18,A,14539,2064,241,2305,0.104555315
20200324,GA,1026,4458,32,A,5484,161,254,415,0.612048193
20200324,GU,32,201,1,0,233,40,3,43,0.069767442
20200324,HI,77,3589,0,A,3666,634,21,655,0.032061069
20200324,IA,124,2315,0,C,2439,272,19,291,0.065292096
20200324,ID,50,1887,0,A,1937,578,3,581,0.005163511
20200324,IL,1535,9934,16,A,11469,1351,262,1613,0.162430254
20200324,IN,365,2566,12,B,2931,865,106,971,0.109165808
20200324,KS,98,2086,2,B,2184,1669,16,1685,0.009495549
20200324,KY,124,1762,4,A,1886,0,20,20,1
20200324,LA,1388,7215,46,A,8603,2439,216,2655,0.081355932
20200324,MA,1060,12714,26,B,13774,4451,382,4833,0.079039934
20200324,MD,349,94,3,D,443,0,61,61,1
20200324,ME,125,3014,0,A,3139,223,18,241,0.074688797
20200324,MI,6441,5796,24,D,12237,1099,652,1751,0.372358652
20200324,MN,262,5550,1,A,5812,1039,27,1066,0.02532833
20200324,MO,183,369,3,C,552,0,0,0,0
20200324,MP,0,0,0,0,0,0,0,0,0
20200324,MS,320,1552,1,B,1872,409,71,480,0.147916667
20200324,MT,46,1643,0,C,1689,497,12,509,0.023575639
20200324,NC,398,8141,0,A,8539,0,101,101,1
20200324,ND,34,1454,0,B,1488,101,4,105,0.038095238
20200324,NE,52,975,0,A,1027,619,2,621,0.003220612
20200324,NH,101,1447,1,B,1548,73,23,96,0.239583333
20200324,NJ,3675,8325,44,B,12000,7966,831,8797,0.094464022
20200324,NM,83,5890,0,A,5973,569,18,587,0.030664395
20200324,NV,278,3954,4,A,4232,464,33,497,0.06639839
20200324,NY,25665,65605,210,B,91270,8191,4790,12981,0.369000847
20200324,OH,564,140,8,D,704,0,122,122,1
20200324,OK,106,735,3,A,841,41,25,66,0.378787879
20200324,OR,209,4350,8,A,4559,701,18,719,0.025034771
20200324,PA,851,8643,7,A,9494,2048,207,2255,0.091796009
20200324,PR,39,268,2,A,307,79,8,87,0.091954023
20200324,RI,124,1200,0,B,1324,57,18,75,0.24
20200324,SC,298,2012,5,B,2310,546,0,546,0
20200324,SD,30,790,1,A,820,28,2,30,0.066666667
20200324,TN,667,10517,2,A,11184,7245,52,7297,0.007126216
20200324,TX,410,10757,9,A,11167,1054,58,1112,0.052158273
20200324,UT,299,5524,1,A,5823,734,42,776,0.054123711
20200324,VA,290,4180,7,A,4470,737,36,773,0.046571798
20200324,VI,17,0,0,0,17,0,0,0,0
20200324,VT,125,1569,7,A,1694,145,28,173,0.161849711
20200324,WA,4038,53326,146,A,57364,4818,434,5252,0.082635187
20200324,WI,457,8237,5,A,8694,1187,41,1228,0.033387622
20200324,WV,20,610,0,B,630,166,4,170,0.023529412
20200324,WY,29,710,0,A,739,118,3,121,0.024793388
20200323,AK,22,946,0,A,968,0,0,0,0
20200323,AL,167,1665,0,C,1832,201,29,230,0.126086957
20200323,AR,174,906,0,A,1080,195,9,204,0.044117647
20200323,AS,0,0,0,0,0,0,0,0,0
20200323,AZ,265,309,2,B,574,27,113,140,0.807142857
20200323,CA,1733,12567,27,B,14300,1263,197,1460,0.134931507
20200323,CO,591,4845,6,A,5436,770,116,886,0.130925508
20200323,CT,415,4085,10,A,4500,1208,192,1400,0.137142857
20200323,DC,116,1113,2,A,1229,156,18,174,0.103448276
20200323,DE,68,36,0,C,104,0,12,12,1
20200323,FL,1171,11063,14,A,12234,3073,341,3414,0.099882835
20200323,GA,772,4297,25,A,5069,877,172,1049,0.163965682
20200323,GU,29,161,1,0,190,35,2,37,0.054054054
20200323,HI,56,2955,0,A,3011,2692,8,2700,0.002962963
20200323,IA,105,2043,0,C,2148,828,15,843,0.017793594
20200323,ID,47,1309,0,A,1356,134,5,139,0.035971223
20200323,IL,1273,8583,12,A,9856,1312,224,1536,0.145833333
20200323,IN,259,1701,7,B,1960,408,58,466,0.124463519
20200323,KS,82,417,2,B,499,0,18,18,1
20200323,KY,104,1762,3,A,1866,290,5,295,0.016949153
20200323,LA,1172,4776,34,B,5948,2115,335,2450,0.136734694
20200323,MA,678,8263,17,B,8941,2787,131,2918,0.044893763
20200323,MD,288,94,3,D,382,0,44,44,1
20200323,ME,107,2791,0,A,2898,527,18,545,0.033027523
20200323,MI,5789,4697,15,D,10486,985,691,1676,0.412291169
20200323,MN,235,4511,1,A,4746,0,66,66,1
20200323,MO,183,369,3,C,552,0,93,93,1
20200323,MP,0,0,0,0,0,0,0,0,0
20200323,MS,249,1143,1,B,1392,29,42,71,0.591549296
20200323,MT,34,1146,0,C,1180,0,3,3,1
20200323,NC,297,8141,0,A,8438,1958,42,2000,0.021
20200323,ND,30,1353,0,B,1383,93,2,95,0.021052632
20200323,NE,50,356,0,A,406,0,2,2,1
20200323,NH,78,1374,0,B,1452,186,13,199,0.065326633
20200323,NJ,2844,359,27,B,3203,32,930,962,0.966735967
20200323,NM,65,5321,0,A,5386,599,8,607,0.013179572
20200323,NV,245,3490,4,A,3735,1042,55,1097,0.050136737
20200323,NY,20875,57414,114,B,78289,11181,5707,16888,0.33793226
20200323,OH,442,140,6,D,582,0,91,91,1
20200323,OK,81,694,2,A,775,25,14,39,0.358974359
20200323,OR,191,3649,5,A,3840,785,30,815,0.036809816
20200323,PA,644,6595,6,A,7239,1631,165,1796,0.091870824
20200323,PR,31,189,2,A,220,6,8,14,0.571428571
20200323,RI,106,1143,0,B,1249,211,23,234,0.098290598
20200323,SC,298,1466,5,A,1764,0,103,103,1
20200323,SD,28,762,1,A,790,22,7,29,0.24137931
20200323,TN,615,3272,2,B,3887,0,110,110,1
20200323,TX,352,9703,8,A,10055,1281,18,1299,0.013856813
20200323,UT,257,4790,1,A,5047,1282,76,1358,0.055964654
20200323,VA,254,3443,6,A,3697,325,35,360,0.097222222
20200323,VI,17,0,0,0,17,0,11,11,1
20200323,VT,97,1424,5,A,1521,220,21,241,0.087136929
20200323,WA,3604,48508,137,A,52112,4845,463,5308,0.087226827
20200323,WI,416,7050,5,A,7466,820,31,851,0.036427732
20200323,WV,16,444,0,B,460,59,4,63,0.063492063
20200323,WY,26,592,0,A,618,154,2,156,0.012820513
20200322,AK,22,946,0,0,968,188,8,196,0.040816327
20200322,AL,138,1464,0,0,1602,1436,14,1450,0.009655172
20200322,AR,165,711,0,0,876,144,47,191,0.246073298
20200322,AS,0,0,0,0,0,0,0,0,0
20200322,AZ,152,282,2,0,434,42,48,90,0.533333333
20200322,CA,1536,11304,27,0,12840,55,257,312,0.823717949
20200322,CO,475,4075,5,0,4550,758,112,870,0.128735632
20200322,CT,223,2877,5,0,3100,771,29,800,0.03625
20200322,DC,98,957,1,0,1055,451,21,472,0.044491525
20200322,DE,56,36,0,0,92,0,11,11,1
20200322,FL,830,7990,13,0,8820,1411,172,1583,0.108654454
20200322,GA,600,3420,23,0,4020,863,93,956,0.097280335
20200322,GU,27,126,1,0,153,18,12,30,0.4
20200322,HI,48,263,0,0,311,139,11,150,0.073333333
20200322,IA,90,1215,0,0,1305,166,22,188,0.117021277
20200322,ID,42,1175,0,0,1217,295,11,306,0.035947712
20200322,IL,1049,7271,9,0,8320,1783,296,2079,0.142376142
20200322,IN,201,1293,6,0,1494,586,75,661,0.113464448
20200322,KS,64,417,2,0,481,0,9,9,1
20200322,KY,99,1472,3,0,1571,758,45,803,0.056039851
20200322,LA,837,2661,20,0,3498,481,257,738,0.348238482
20200322,MA,547,5476,11,0,6023,677,121,798,0.151629073
20200322,MD,244,94,3,0,338,0,54,54,1
20200322,ME,89,2264,0,0,2353,0,16,16,1
20200322,MI,5098,3712,8,0,8810,16,555,571,0.971978984
20200322,MN,169,4511,1,0,4680,559,31,590,0.052542373
20200322,MO,90,369,3,0,459,0,17,17,1
20200322,MP,0,0,0,0,0,0,0,0,0
20200322,MS,207,1114,1,0,1321,419,67,486,0.137860082
20200322,MT,31,1146,0,0,1177,0,11,11,1
20200322,NC,255,6183,0,0,6438,1091,71,1162,0.061101549
20200322,ND,28,1260,0,0,1288,119,0,119,0
20200322,NE,48,356,0,0,404,0,10,10,1
20200322,NH,65,1188,0,0,1253,215,10,225,0.044444444
20200322,NJ,1914,327,20,0,2241,33,587,620,0.946774194
20200322,NM,57,4722,0,0,4779,951,0,951,0
20200322,NV,190,2448,2,0,2638,64,66,130,0.507692308
20200322,NY,15168,46233,114,0,61401,11152,4812,15964,0.301428213
20200322,OH,351,140,3,0,491,0,104,104,1
20200322,OK,67,669,2,0,736,109,14,123,0.113821138
20200322,OR,161,2864,4,0,3025,861,47,908,0.051762115
20200322,PA,479,4964,2,0,5443,1198,108,1306,0.082695253
20200322,PR,23,183,1,0,206,40,2,42,0.047619048
20200322,RI,83,932,0,0,1015,70,17,87,0.195402299
20200322,SC,195,1466,3,0,1661,211,43,254,0.169291339
20200322,SD,21,740,1,0,761,49,7,56,0.125
20200322,TN,505,3272,0,0,3777,0,134,134,1
20200322,TX,334,8422,5,0,8756,2204,30,2234,0.013428827
20200322,UT,181,3508,1,0,3689,1084,45,1129,0.039858282
20200322,VA,219,3118,3,0,3337,480,67,547,0.122486289
20200322,VI,6,0,0,0,6,0,0,0,0
20200322,VT,76,1204,2,0,1280,124,24,148,0.162162162
20200322,WA,3141,43663,126,0,46804,1707,183,1890,0.096825397
20200322,WI,385,6230,4,0,6615,1602,104,1706,0.060961313
20200322,WV,12,385,0,0,397,55,1,56,0.017857143
20200322,WY,24,438,0,0,462,0,1,1,1
20200321,AK,14,758,0,0,772,72,2,74,0.027027027
20200321,AL,124,28,0,0,152,0,43,43,1
20200321,AR,118,567,0,0,685,216,22,238,0.092436975
20200321,AS,0,0,0,0,0,0,0,0,0
20200321,AZ,104,240,1,0,344,29,39,68,0.573529412
20200321,CA,1279,11249,24,0,12528,825,216,1041,0.207492795
20200321,CO,363,3317,4,0,3680,642,86,728,0.118131868
20200321,CT,194,2106,4,0,2300,1502,0,1502,0
20200321,DC,77,506,1,0,583,5,6,11,0.545454545
20200321,DE,45,36,0,0,81,0,7,7,1
20200321,FL,658,6579,12,0,7237,4709,138,4847,0.028471219
20200321,GA,507,2557,14,0,3064,591,87,678,0.128318584
20200321,GU,15,108,0,0,123,22,1,23,0.043478261
20200321,HI,37,124,0,0,161,0,11,11,1
20200321,IA,68,1049,0,0,1117,407,23,430,0.053488372
20200321,ID,31,880,0,0,911,290,8,298,0.026845638
20200321,IL,753,5488,6,0,6241,1792,168,1960,0.085714286
20200321,IN,126,707,4,0,833,232,47,279,0.168458781
20200321,KS,55,417,2,0,472,0,11,11,1
20200321,KY,54,714,2,0,768,122,7,129,0.054263566
20200321,LA,580,2180,16,0,2760,1612,107,1719,0.062245492
20200321,MA,426,4799,7,0,5225,1004,112,1116,0.100358423
20200321,MD,190,94,2,0,284,0,41,41,1
20200321,ME,73,2264,0,0,2337,0,16,16,1
20200321,MI,4543,3696,5,0,8239,950,516,1466,0.351978172
20200321,MN,138,3952,1,0,4090,211,23,234,0.098290598
20200321,MO,73,369,3,0,442,0,26,26,1
20200321,MP,0,0,0,0,0,0,0,0,0
20200321,MS,140,695,1,0,835,0,60,60,1
20200321,MT,20,1146,0,0,1166,215,4,219,0.01826484
20200321,NC,184,5092,0,0,5276,1996,47,2043,0.023005384
20200321,ND,28,1141,0,0,1169,341,8,349,0.022922636
20200321,NE,38,356,0,0,394,116,6,122,0.049180328
20200321,NH,55,973,0,0,1028,228,11,239,0.046025105
20200321,NJ,1327,294,16,0,1621,30,437,467,0.935760171
20200321,NM,57,3771,0,0,3828,0,14,14,1
20200321,NV,124,2384,2,0,2508,392,15,407,0.036855037
20200321,NY,10356,35081,44,0,45437,9756,3254,13010,0.250115296
20200321,OH,247,140,3,0,387,0,78,78,1
20200321,OK,53,560,1,0,613,22,4,26,0.153846154
20200321,OR,114,2003,3,0,2117,0,0,0,0
20200321,PA,371,3766,2,0,4137,1192,103,1295,0.07953668
20200321,PR,21,143,0,0,164,29,7,36,0.194444444
20200321,RI,66,862,0,0,928,62,12,74,0.162162162
20200321,SC,152,1255,1,0,1407,422,71,493,0.144016227
20200321,SD,14,691,1,0,705,28,0,28,0
20200321,TN,371,3272,0,0,3643,2709,143,2852,0.050140252
20200321,TX,304,6218,5,0,6522,1135,110,1245,0.088353414
20200321,UT,136,2424,0,0,2560,389,24,413,0.05811138
20200321,VA,152,2638,2,0,2790,427,38,465,0.08172043
20200321,VI,6,0,0,0,6,0,3,3,1
20200321,VT,52,1080,2,0,1132,123,8,131,0.061068702
20200321,WA,2958,41956,111,0,44914,2151,194,2345,0.082729211
20200321,WI,281,4628,4,0,4909,1173,75,1248,0.060096154
20200321,WV,11,330,0,0,341,111,4,115,0.034782609
20200321,WY,23,438,0,0,461,107,4,111,0.036036036
20200320,AK,12,686,0,0,698,254,6,260,0.023076923
20200320,AL,81,28,0,0,109,0,13,13,1
20200320,AR,96,351,0,0,447,41,50,91,0.549450549
20200320,AS,0,0,0,0,0,0,0,0,0
20200320,AZ,65,211,0,0,276,36,21,57,0.368421053
20200320,CA,1063,10424,20,0,11487,1637,139,1776,0.078265766
20200320,CO,277,2675,3,0,2952,563,61,624,0.09775641
20200320,CT,194,604,3,0,798,0,98,98,1
20200320,DC,71,501,1,0,572,348,32,380,0.084210526
20200320,DE,38,36,0,0,74,0,8,8,1
20200320,FL,520,1870,10,0,2390,337,130,467,0.278372591
20200320,GA,420,1966,13,0,2386,422,133,555,0.23963964
20200320,GU,14,86,0,0,100,17,2,19,0.105263158
20200320,HI,26,124,0,0,150,31,10,41,0.243902439
20200320,IA,45,642,0,0,687,559,7,566,0.012367491
20200320,ID,23,590,0,0,613,131,12,143,0.083916084
20200320,IL,585,3696,5,0,4281,971,163,1134,0.143738977
20200320,IN,79,475,2,0,554,151,23,174,0.132183908
20200320,KS,44,417,1,0,461,0,10,10,1
20200320,KY,47,592,1,0,639,138,12,150,0.08
20200320,LA,473,568,12,0,1041,110,126,236,0.533898305
20200320,MA,314,3795,5,0,4109,877,85,962,0.088357588
20200320,MD,149,94,1,0,243,0,42,42,1
20200320,ME,57,2264,0,0,2321,260,4,264,0.015151515
20200320,MI,4027,2746,3,0,6773,961,635,1596,0.397869674
20200320,MN,115,3741,0,0,3856,792,26,818,0.031784841
20200320,MO,47,369,1,0,416,61,23,84,0.273809524
20200320,MP,0,0,0,0,0,0,0,0,0
20200320,MS,80,695,1,0,775,143,30,173,0.173410405
20200320,MT,16,931,0,0,947,170,4,174,0.022988506
20200320,NC,137,3096,0,0,3233,688,40,728,0.054945055
20200320,ND,20,800,0,0,820,307,5,312,0.016025641
20200320,NE,32,240,0,0,272,0,5,5,1
20200320,NH,44,745,0,0,789,124,5,129,0.03875969
20200320,NJ,890,264,11,0,1154,54,148,202,0.732673267
20200320,NM,43,3771,0,0,3814,1009,8,1017,0.007866273
20200320,NV,109,1992,1,0,2101,366,14,380,0.036842105
20200320,NY,7102,25325,35,0,32427,7193,2950,10143,0.290840974
20200320,OH,169,140,1,0,309,0,50,50,1
20200320,OK,49,538,1,0,587,72,5,77,0.064935065
20200320,OR,114,2003,3,0,2117,674,26,700,0.037142857
20200320,PA,268,2574,1,0,2842,966,83,1049,0.079122974
20200320,PR,14,114,0,0,128,58,9,67,0.134328358
20200320,RI,54,800,0,0,854,146,10,156,0.064102564
20200320,SC,81,833,1,0,914,250,21,271,0.077490775
20200320,SD,14,663,1,0,677,112,3,115,0.026086957
20200320,TN,228,563,0,0,791,214,74,288,0.256944444
20200320,TX,194,5083,5,0,5277,2871,51,2922,0.017453799
20200320,UT,112,2035,0,0,2147,587,34,621,0.054750403
20200320,VA,114,2211,2,0,2325,382,20,402,0.049751244
20200320,VI,3,0,0,0,3,0,0,0,0
20200320,VT,44,957,2,0,1001,193,16,209,0.076555024
20200320,WA,2764,39805,104,0,42569,3765,303,4068,0.074483776
20200320,WI,206,3455,3,0,3661,1263,51,1314,0.038812785
20200320,WV,7,219,0,0,226,76,5,81,0.061728395
20200320,WY,19,331,0,0,350,60,1,61,0.016393443
20200319,AK,6,432,0,0,438,26,0,26,0
20200319,AL,68,28,0,0,96,0,22,22,1
20200319,AR,46,310,0,0,356,74,13,87,0.149425287
20200319,AS,0,0,0,0,0,0,0,0,0
20200319,AZ,44,175,0,0,219,27,16,43,0.372093023
20200319,CA,924,8787,18,0,9711,806,313,1119,0.27971403
20200319,CO,216,2112,2,0,2328,495,33,528,0.0625
20200319,CT,96,604,1,0,700,479,28,507,0.055226824
20200319,DC,39,153,0,0,192,15,8,23,0.347826087
20200319,DE,30,36,0,0,66,0,5,5,1
20200319,FL,390,1533,8,0,1923,308,76,384,0.197916667
20200319,GA,287,1544,10,0,1831,233,90,323,0.278637771
20200319,GU,12,69,0,0,81,12,4,16,0.25
20200319,HI,16,93,0,0,109,0,2,2,1
20200319,IA,38,83,0,0,121,0,9,9,1
20200319,ID,11,459,0,0,470,0,2,2,1
20200319,IL,422,2725,4,0,3147,962,134,1096,0.122262774
20200319,IN,56,324,2,0,380,170,17,187,0.090909091
20200319,KS,34,417,1,0,451,0,18,18,1
20200319,KY,35,454,1,0,489,100,9,109,0.082568807
20200319,LA,347,458,8,0,805,123,107,230,0.465217391
20200319,MA,229,2918,3,0,3147,803,73,876,0.083333333
20200319,MD,107,94,1,0,201,0,22,22,1
20200319,ME,53,2004,0,0,2057,334,10,344,0.029069767
20200319,MI,3392,1785,3,0,5177,570,479,1049,0.456625357
20200319,MN,89,2949,0,0,3038,264,12,276,0.043478261
20200319,MO,24,308,1,0,332,55,11,66,0.166666667
20200319,MP,0,0,0,0,0,0,0,0,0
20200319,MS,50,552,0,0,602,73,16,89,0.179775281
20200319,MT,12,761,0,0,773,262,2,264,0.007575758
20200319,NC,97,2408,0,0,2505,621,34,655,0.051908397
20200319,ND,15,493,0,0,508,225,9,234,0.038461538
20200319,NE,27,240,0,0,267,34,3,37,0.081081081
20200319,NH,39,621,0,0,660,108,13,121,0.107438017
20200319,NJ,742,210,9,0,952,20,315,335,0.940298507
20200319,NM,35,2762,0,0,2797,436,7,443,0.015801354
20200319,NV,95,1626,1,0,1721,1458,40,1498,0.02670227
20200319,NY,4152,18132,12,0,22284,5917,1770,7687,0.230258879
20200319,OH,119,140,0,0,259,0,31,31,1
20200319,OK,44,466,1,0,510,88,15,103,0.145631068
20200319,OR,88,1329,3,0,1417,211,13,224,0.058035714
20200319,PA,185,1608,1,0,1793,421,52,473,0.109936575
20200319,PR,5,56,0,0,61,25,0,25,0
20200319,RI,44,654,0,0,698,114,11,125,0.088
20200319,SC,60,583,1,0,643,0,0,0,0
20200319,SD,11,551,1,0,562,0,0,0,0
20200319,TN,154,349,0,0,503,0,56,56,1
20200319,TX,143,2212,3,0,2355,388,60,448,0.133928571
20200319,UT,78,1448,0,0,1526,1317,15,1332,0.011261261
20200319,VA,94,1829,2,0,1923,628,17,645,0.026356589
20200319,VI,3,0,0,0,3,0,1,1,1
20200319,VT,28,764,0,0,792,127,7,134,0.052238806
20200319,WA,2461,36040,92,0,38501,4228,332,4560,0.072807018
20200319,WI,155,2192,0,0,2347,615,49,664,0.073795181
20200319,WV,2,143,0,0,145,21,1,22,0.045454545
20200319,WY,18,271,0,0,289,93,3,96,0.03125
20200318,AK,6,406,0,0,412,72,3,75,0.04
20200318,AL,46,28,0,0,74,0,10,10,1
20200318,AR,33,236,0,0,269,39,11,50,0.22
20200318,AS,0,0,0,0,0,0,0,0,0
20200318,AZ,28,148,0,0,176,6,8,14,0.571428571
20200318,CA,611,7981,13,0,8592,0,128,128,1
20200318,CO,183,1617,2,0,1800,561,23,584,0.039383562
20200318,CT,68,125,0,0,193,0,27,27,1
20200318,DC,31,138,0,0,169,34,9,43,0.209302326
20200318,DE,25,36,0,0,61,0,9,9,1
20200318,FL,314,1225,7,0,1539,285,128,413,0.309927361
20200318,GA,197,1311,1,0,1508,1311,51,1362,0.037444934
20200318,GU,8,57,0,0,65,16,3,19,0.157894737
20200318,HI,14,93,0,0,107,93,4,97,0.041237113
20200318,IA,29,83,0,0,112,0,6,6,1
20200318,ID,9,459,0,0,468,113,2,115,0.017391304
20200318,IL,288,1763,1,0,2051,423,129,552,0.233695652
20200318,IN,39,154,2,0,193,25,9,34,0.264705882
20200318,KS,16,417,1,0,433,35,1,36,0.027777778
20200318,KY,26,354,1,0,380,59,4,63,0.063492063
20200318,LA,240,335,6,0,575,49,103,152,0.677631579
20200318,MA,156,2115,2,0,2271,482,38,520,0.073076923
20200318,MD,85,94,0,0,179,0,28,28,1
20200318,ME,43,1670,0,0,1713,367,11,378,0.029100529
20200318,MI,2913,1215,0,0,4128,589,520,1109,0.468890893
20200318,MN,77,2685,0,0,2762,409,17,426,0.039906103
20200318,MO,13,253,0,0,266,46,5,51,0.098039216
20200318,MP,0,0,0,0,0,0,0,0,0
20200318,MS,34,479,0,0,513,111,13,124,0.10483871
20200318,MT,10,499,0,0,509,196,2,198,0.01010101
20200318,NC,63,1787,0,0,1850,1313,23,1336,0.017215569
20200318,ND,6,268,0,0,274,48,3,51,0.058823529
20200318,NE,24,206,0,0,230,0,3,3,1
20200318,NH,26,513,0,0,539,158,9,167,0.053892216
20200318,NJ,427,190,5,0,617,27,160,187,0.855614973
20200318,NM,28,2326,0,0,2354,1077,5,1082,0.004621072
20200318,NV,55,168,1,0,223,0,0,0,0
20200318,NY,2382,12215,12,0,14597,6709,682,7391,0.092274388
20200318,OH,88,140,0,0,228,0,21,21,1
20200318,OK,29,378,0,0,407,131,12,143,0.083916084
20200318,OR,75,1118,3,0,1193,429,28,457,0.061269147
20200318,PA,133,1187,1,0,1320,308,37,345,0.107246377
20200318,PR,5,31,0,0,36,18,0,18,0
20200318,RI,33,540,0,0,573,137,10,147,0.068027211
20200318,SC,60,583,1,0,643,272,27,299,0.090301003
20200318,SD,11,551,1,0,562,0,0,0,0
20200318,TN,98,349,0,0,447,19,25,44,0.568181818
20200318,TX,83,1824,2,0,1907,620,19,639,0.029733959
20200318,UT,63,131,0,0,194,0,12,12,1
20200318,VA,77,1201,1,0,1278,240,10,250,0.04
20200318,VI,2,0,0,0,2,0,0,0,0
20200318,VT,21,637,0,0,658,56,2,58,0.034482759
20200318,WA,2129,31812,82,0,33941,4468,289,4757,0.060752575
20200318,WI,106,1577,0,0,1683,539,34,573,0.059336824
20200318,WV,1,122,0,0,123,42,1,43,0.023255814
20200318,WY,15,178,0,0,193,83,5,88,0.056818182
20200317,AK,3,334,0,0,337,191,2,193,0.010362694
20200317,AL,36,28,0,0,64,0,8,8,1
20200317,AR,22,197,0,0,219,65,0,65,0
20200317,AS,0,0,0,0,0,0,0,0,0
20200317,AZ,20,142,0,0,162,17,2,19,0.105263158
20200317,CA,483,7981,11,0,8464,0,148,148,1
20200317,CO,160,1056,1,0,1216,429,29,458,0.063318777
20200317,CT,41,125,0,0,166,0,15,15,1
20200317,DC,22,104,0,0,126,8,5,13,0.384615385
20200317,DE,16,36,0,0,52,0,8,8,1
20200317,FL,186,940,6,0,1126,256,45,301,0.149501661
20200317,GA,146,0,1,0,146,0,25,25,1
20200317,GU,5,41,0,0,46,18,2,20,0.1
20200317,HI,10,0,0,0,10,0,3,3,1
20200317,IA,23,83,0,0,106,0,1,1,1
20200317,ID,7,346,0,0,353,81,2,83,0.024096386
20200317,IL,159,1340,1,0,1499,408,66,474,0.139240506
20200317,IN,30,129,2,0,159,14,6,20,0.3
20200317,KS,15,382,1,0,397,216,4,220,0.018181818
20200317,KY,22,295,1,0,317,61,1,62,0.016129032
20200317,LA,137,286,4,0,423,98,22,120,0.183333333
20200317,MA,118,1633,0,0,1751,434,21,455,0.046153846
20200317,MD,57,94,0,0,151,0,20,20,1
20200317,ME,32,1303,0,0,1335,539,15,554,0.027075812
20200317,MI,2393,626,0,0,3019,354,460,814,0.565110565
20200317,MN,60,2276,0,0,2336,437,6,443,0.013544018
20200317,MO,8,207,0,0,215,43,2,45,0.044444444
20200317,MP,0,0,0,0,0,0,0,0,0
20200317,MS,21,368,0,0,389,91,9,100,0.09
20200317,MT,8,303,0,0,311,105,1,106,0.009433962
20200317,NC,40,474,0,0,514,178,7,185,0.037837838
20200317,ND,3,220,0,0,223,97,2,99,0.02020202
20200317,NE,21,206,0,0,227,36,3,39,0.076923077
20200317,NH,17,355,0,0,372,84,4,88,0.045454545
20200317,NJ,267,163,3,0,430,43,89,132,0.674242424
20200317,NM,23,1249,0,0,1272,683,6,689,0.008708273
20200317,NV,55,168,1,0,223,0,10,10,1
20200317,NY,1700,5506,7,0,7206,963,750,1713,0.437828371
20200317,OH,67,140,0,0,207,0,17,17,1
20200317,OK,17,247,0,0,264,73,7,80,0.0875
20200317,OR,47,689,0,0,736,110,8,118,0.06779661
20200317,PA,96,879,0,0,975,209,20,229,0.087336245
20200317,PR,5,13,0,0,18,4,0,4,0
20200317,RI,23,403,0,0,426,95,2,97,0.020618557
20200317,SC,33,311,1,0,344,76,5,81,0.061728395
20200317,SD,11,551,0,0,562,57,1,58,0.017241379
20200317,TN,73,330,0,0,403,60,21,81,0.259259259
20200317,TX,64,1204,1,0,1268,1204,7,1211,0.005780347
20200317,UT,51,131,0,0,182,0,12,12,1
20200317,VA,67,961,1,0,1028,523,16,539,0.029684601
20200317,VI,2,0,0,0,2,0,1,1,1
20200317,VT,19,581,0,0,600,94,2,96,0.020833333
20200317,WA,1840,27344,78,0,29184,4387,263,4650,0.05655914
20200317,WI,72,1038,0,0,1110,534,25,559,0.044722719
20200317,WV,0,80,0,0,80,0,0,0,0
20200317,WY,10,95,0,0,105,95,7,102,0.068627451
20200316,AK,1,143,0,0,144,0,0,0,0
20200316,AL,28,28,0,0,56,0,16,16,1
20200316,AR,22,132,0,0,154,29,6,35,0.171428571
20200316,AS,0,0,0,0,0,0,0,0,0
20200316,AZ,18,125,0,0,143,4,6,10,0.6
20200316,CA,335,7981,6,0,8316,7065,42,7107,0.005909667
20200316,CO,131,627,1,0,758,0,0,0,0
20200316,CT,26,125,0,0,151,0,6,6,1
20200316,DC,17,96,0,0,113,17,1,18,0.055555556
20200316,DE,8,36,0,0,44,0,2,2,1
20200316,FL,141,684,4,0,825,6,25,31,0.806451613
20200316,GA,121,0,1,0,121,0,22,22,1
20200316,GU,3,23,0,0,26,0,0,0,0
20200316,HI,7,0,0,0,7,0,5,5,1
20200316,IA,22,83,0,0,105,0,4,4,1
20200316,ID,5,265,0,0,270,91,0,91,0
20200316,IL,93,932,0,0,1025,483,29,512,0.056640625
20200316,IN,24,115,1,0,139,13,5,18,0.277777778
20200316,KS,11,166,1,0,177,31,3,34,0.088235294
20200316,KY,21,234,1,0,255,95,5,100,0.05
20200316,LA,115,188,2,0,303,32,25,57,0.438596491
20200316,MA,97,1199,0,0,1296,615,33,648,0.050925926
20200316,MD,37,94,0,0,131,0,6,6,1
20200316,ME,17,764,0,0,781,673,14,687,0.020378457
20200316,MI,1933,272,0,0,2205,67,453,520,0.871153846
20200316,MN,54,1839,0,0,1893,452,19,471,0.040339703
20200316,MO,6,164,0,0,170,42,1,43,0.023255814
20200316,MP,0,0,0,0,0,0,0,0,0
20200316,MS,12,277,0,0,289,193,2,195,0.01025641
20200316,MT,7,198,0,0,205,95,0,95,0
20200316,NC,33,296,0,0,329,69,1,70,0.014285714
20200316,ND,1,123,0,0,124,28,0,28,0
20200316,NE,18,170,0,0,188,90,1,91,0.010989011
20200316,NH,13,271,0,0,284,0,0,0,0
20200316,NJ,178,120,2,0,298,0,80,80,1
20200316,NM,17,566,0,0,583,84,4,88,0.045454545
20200316,NV,45,168,1,0,213,0,24,24,1
20200316,NY,950,4543,7,0,5493,0,221,221,1
20200316,OH,50,140,0,0,190,1,14,15,0.933333333
20200316,OK,10,174,0,0,184,56,1,57,0.01754386
20200316,OR,39,579,0,0,618,159,3,162,0.018518519
20200316,PA,76,670,0,0,746,465,13,478,0.027196653
20200316,PR,5,9,0,0,14,0,0,0,0
20200316,RI,21,308,0,0,329,37,1,38,0.026315789
20200316,SC,28,235,1,0,263,81,9,90,0.1
20200316,SD,10,494,0,0,504,167,1,168,0.005952381
20200316,TN,52,270,0,0,322,113,13,126,0.103174603
20200316,TX,57,0,0,0,57,0,1,1,1
20200316,UT,39,131,0,0,170,0,11,11,1
20200316,VA,51,438,1,0,489,75,6,81,0.074074074
20200316,VI,1,0,0,0,1,0,0,0,0
20200316,VT,17,487,0,0,504,82,5,87,0.057471264
20200316,WA,1577,22957,69,0,24534,4604,300,4904,0.061174551
20200316,WI,47,504,0,0,551,191,14,205,0.068292683
20200316,WV,0,80,0,0,80,42,0,42,0
20200316,WY,3,0,0,0,3,0,0,0,0
20200315,AK,1,143,0,0,144,0,0,0,0
20200315,AL,12,28,0,0,40,6,6,12,0.5
20200315,AR,16,103,0,0,119,38,4,42,0.095238095
20200315,AZ,12,121,0,0,133,0,0,0,0
20200315,CA,293,916,5,0,1209,0,41,41,1
20200315,CO,131,627,1,0,758,17,30,47,0.638297872
20200315,CT,20,125,0,0,145,0,9,9,1
20200315,DC,16,79,0,0,95,30,6,36,0.166666667
20200315,DE,6,36,0,0,42,0,0,0,0
20200315,FL,116,678,4,0,794,200,39,239,0.163179916
20200315,GA,99,0,1,0,99,0,33,33,1
20200315,HI,2,0,0,0,2,0,0,0,0
20200315,IA,18,83,0,0,101,0,1,1,1
20200315,ID,5,174,0,0,179,0,3,3,1
20200315,IL,64,449,0,0,513,133,18,151,0.119205298
20200315,IN,19,102,0,0,121,28,4,32,0.125
20200315,KS,8,135,1,0,143,42,2,44,0.045454545
20200315,KY,16,139,0,0,155,0,2,2,1
20200315,LA,90,156,2,0,246,47,39,86,0.453488372
20200315,MA,64,584,0,0,648,584,26,610,0.042622951
20200315,MD,31,94,0,0,125,0,5,5,1
20200315,ME,3,91,0,0,94,0,0,0,0
20200315,MI,1480,205,0,0,1685,0,284,284,1
20200315,MN,35,1387,0,0,1422,540,14,554,0.025270758
20200315,MO,5,122,0,0,127,32,1,33,0.03030303
20200315,MS,10,84,0,0,94,0,4,4,1
20200315,MT,7,103,0,0,110,0,2,2,1
20200315,NC,32,227,0,0,259,90,9,99,0.090909091
20200315,ND,1,95,0,0,96,41,0,41,0
20200315,NE,17,80,0,0,97,0,3,3,1
20200315,NH,13,271,0,0,284,59,6,65,0.092307692
20200315,NJ,98,120,2,0,218,23,48,71,0.676056338
20200315,NM,13,482,0,0,495,245,3,248,0.012096774
20200315,NV,21,168,0,0,189,0,1,1,1
20200315,NY,729,4543,3,0,5272,1764,205,1969,0.104113763
20200315,OH,36,139,0,0,175,89,23,112,0.205357143
20200315,OK,9,118,0,0,127,82,5,87,0.057471264
20200315,OR,36,420,0,0,456,83,6,89,0.06741573
20200315,PA,63,205,0,0,268,0,16,16,1
20200315,RI,20,271,0,0,291,73,0,73,0
20200315,SC,19,154,0,0,173,44,6,50,0.12
20200315,SD,9,327,0,0,336,145,0,145,0
20200315,TN,39,157,0,0,196,27,7,34,0.205882353
20200315,TX,56,0,0,0,56,0,5,5,1
20200315,UT,28,131,0,0,159,0,22,22,1
20200315,VA,45,363,1,0,408,246,15,261,0.057471264
20200315,VT,12,405,0,0,417,73,4,77,0.051948052
20200315,WA,1277,18353,57,0,19630,1585,106,1691,0.062684802
20200315,WI,33,313,0,0,346,144,14,158,0.088607595
20200315,WV,0,38,0,0,38,12,0,12,0
20200315,WY,3,0,0,0,3,0,1,1,1
20200314,AK,1,143,0,0,144,84,0,84,0
20200314,AL,6,22,0,0,28,11,5,16,0.3125
20200314,AR,12,65,0,0,77,35,3,38,0.078947368
20200314,AZ,12,121,0,0,133,27,3,30,0.1
20200314,CA,252,916,5,0,1168,0,50,50,1
20200314,CO,101,610,1,0,711,86,29,115,0.252173913
20200314,CT,11,125,0,0,136,26,5,31,0.161290323
20200314,DC,10,49,0,0,59,29,0,29,0
20200314,DE,6,36,0,0,42,6,2,8,0.25
20200314,FL,77,478,3,0,555,0,27,27,1
20200314,GA,66,0,1,0,66,0,24,24,1
20200314,HI,2,0,0,0,2,0,0,0,0
20200314,IA,17,83,0,0,100,0,1,1,1
20200314,ID,2,174,0,0,176,43,2,45,0.044444444
20200314,IL,46,316,0,0,362,22,14,36,0.388888889
20200314,IN,15,74,0,0,89,13,3,16,0.1875
20200314,KS,6,93,1,0,99,0,0,0,0
20200314,KY,14,139,0,0,153,32,3,35,0.085714286
20200314,LA,51,109,0,0,160,72,15,87,0.172413793
20200314,MA,38,0,0,0,38,0,15,15,1
20200314,MD,26,94,0,0,120,0,9,9,1
20200314,ME,3,91,0,0,94,0,0,0,0
20200314,MI,1196,205,0,0,1401,72,251,323,0.777089783
20200314,MN,21,847,0,0,868,306,7,313,0.022364217
20200314,MO,4,90,0,0,94,19,2,21,0.095238095
20200314,MS,6,84,0,0,90,43,2,45,0.044444444
20200314,MT,5,103,0,0,108,48,4,52,0.076923077
20200314,NC,23,137,0,0,160,51,8,59,0.13559322
20200314,ND,1,54,0,0,55,15,0,15,0
20200314,NE,14,80,0,0,94,0,1,1,1
20200314,NH,7,212,0,0,219,118,1,119,0.008403361
20200314,NJ,50,97,1,0,147,0,0,0,0
20200314,NM,10,237,0,0,247,47,0,47,0
20200314,NV,20,168,0,0,188,0,9,9,1
20200314,NY,524,2779,0,0,3303,0,103,103,1
20200314,OH,13,50,0,0,63,0,0,0,0
20200314,OK,4,36,0,0,40,0,1,1,1
20200314,OR,30,337,0,0,367,0,0,0,0
20200314,PA,47,205,0,0,252,65,6,71,0.084507042
20200314,RI,20,198,0,0,218,56,6,62,0.096774194
20200314,SC,13,110,0,0,123,35,1,36,0.027777778
20200314,SD,9,182,0,0,191,109,0,109,0
20200314,TN,32,130,0,0,162,14,6,20,0.3
20200314,TX,51,0,0,0,51,0,12,12,1
20200314,UT,6,131,0,0,137,0,0,0,0
20200314,VA,30,117,0,0,147,0,0,0,0
20200314,VT,8,332,0,0,340,109,3,112,0.026785714
20200314,WA,1171,16768,51,0,17939,2183,156,2339,0.066695169
20200314,WI,19,169,0,0,188,0,0,0,0
20200314,WV,0,26,0,0,26,9,0,9,0
20200314,WY,2,0,0,0,2,0,1,1,1
20200313,AK,1,59,0,0,60,13,1,14,0.071428571
20200313,AL,1,11,0,0,12,1,1,2,0.5
20200313,AR,9,30,0,0,39,6,3,9,0.333333333
20200313,AZ,9,94,0,0,103,12,0,12,0
20200313,CA,202,916,4,0,1118,0,0,0,0
20200313,CO,72,524,0,0,596,226,27,253,0.106719368
20200313,CT,6,99,0,0,105,10,0,10,0
20200313,DC,10,20,0,0,30,0,0,0,0
20200313,DE,4,30,0,0,34,7,0,7,0
20200313,FL,50,478,2,0,528,177,18,195,0.092307692
20200313,GA,42,0,1,0,42,0,11,11,1
20200313,HI,2,0,0,0,2,0,0,0,0
20200313,IA,16,83,0,0,99,16,2,18,0.111111111
20200313,ID,0,131,0,0,131,38,0,38,0
20200313,IL,32,294,0,0,326,28,7,35,0.2
20200313,IN,12,61,0,0,73,9,0,9,0
20200313,KS,6,93,0,0,99,52,2,54,0.037037037
20200313,KY,11,107,0,0,118,51,3,54,0.055555556
20200313,LA,36,37,0,0,73,0,22,22,1
20200313,MA,23,0,0,0,23,0,15,15,1
20200313,MD,17,94,0,0,111,0,5,5,1
20200313,ME,3,91,0,0,94,26,2,28,0.071428571
20200313,MI,945,133,0,0,1078,42,243,285,0.852631579
20200313,MN,14,541,0,0,555,234,5,239,0.020920502
20200313,MO,2,71,0,0,73,7,1,8,0.125
20200313,MS,4,41,0,0,45,0,3,3,1
20200313,MT,1,55,0,0,56,21,0,21,0
20200313,NC,15,86,0,0,101,26,3,29,0.103448276
20200313,ND,1,39,0,0,40,27,0,27,0
20200313,NE,13,80,0,0,93,0,3,3,1
20200313,NH,6,94,0,0,100,0,0,0,0
20200313,NJ,50,97,1,0,147,23,20,43,0.465116279
20200313,NM,10,190,0,0,200,35,5,40,0.125
20200313,NV,11,168,0,0,179,0,4,4,1
20200313,NY,421,2779,0,0,3200,2687,205,2892,0.070885201
20200313,OH,13,50,0,0,63,20,8,28,0.285714286
20200313,OK,3,36,0,0,39,0,0,0,0
20200313,OR,30,337,0,0,367,51,11,62,0.177419355
20200313,PA,41,140,0,0,181,24,19,43,0.441860465
20200313,RI,14,142,0,0,156,48,9,57,0.157894737
20200313,SC,12,75,0,0,87,27,2,29,0.068965517
20200313,SD,9,73,0,0,82,46,1,47,0.021276596
20200313,TN,26,116,0,0,142,37,8,45,0.177777778
20200313,TX,39,0,0,0,39,0,16,16,1
20200313,UT,6,131,0,0,137,0,2,2,1
20200313,VA,30,117,0,0,147,0,13,13,1
20200313,VT,5,223,0,0,228,87,3,90,0.033333333
20200313,WA,1015,14585,47,0,15600,4022,216,4238,0.050967437
20200313,WI,19,169,0,0,188,85,11,96,0.114583333
20200313,WV,0,17,0,0,17,10,0,10,0
20200313,WY,1,0,0,0,1,0,0,0,0
20200312,AK,0,46,0,0,46,0,0,0,0
20200312,AL,0,10,0,0,10,0,0,0,0
20200312,AR,6,24,0,0,30,12,6,18,0.333333333
20200312,AZ,9,82,0,0,91,23,0,23,0
20200312,CA,202,916,4,0,1118,0,45,45,1
20200312,CO,45,298,0,0,343,47,17,64,0.265625
20200312,CT,6,89,0,0,95,18,3,21,0.142857143
20200312,DC,10,20,0,0,30,0,5,5,1
20200312,DE,4,23,0,0,27,6,3,9,0.333333333
20200312,FL,32,301,2,0,333,0,4,4,1
20200312,GA,31,0,0,0,31,0,9,9,1
20200312,HI,2,0,0,0,2,0,0,0,0
20200312,IA,14,67,0,0,81,21,1,22,0.045454545
20200312,ID,0,93,0,0,93,26,0,26,0
20200312,IL,25,266,0,0,291,22,6,28,0.214285714
20200312,IN,12,52,0,0,64,19,2,21,0.095238095
20200312,KS,4,41,0,0,45,0,3,3,1
20200312,KY,8,56,0,0,64,10,0,10,0
20200312,LA,14,37,0,0,51,0,8,8,1
20200312,MA,8,0,0,0,8,0,0,0,0
20200312,MD,12,94,0,0,106,0,3,3,1
20200312,ME,1,65,0,0,66,23,1,24,0.041666667
20200312,MI,702,91,0,0,793,34,205,239,0.857740586
20200312,MN,9,307,0,0,316,90,4,94,0.042553191
20200312,MO,1,64,0,0,65,64,0,64,0
20200312,MS,1,41,0,0,42,21,1,22,0.045454545
20200312,MT,1,34,0,0,35,13,1,14,0.071428571
20200312,NC,12,60,0,0,72,60,5,65,0.076923077
20200312,ND,1,12,0,0,13,5,1,6,0.166666667
20200312,NE,10,80,0,0,90,33,5,38,0.131578947
20200312,NH,6,94,0,0,100,56,2,58,0.034482759
20200312,NJ,30,74,1,0,104,17,6,23,0.260869565
20200312,NM,5,155,0,0,160,68,2,70,0.028571429
20200312,NV,7,168,0,0,175,0,2,2,1
20200312,NY,216,92,0,0,308,0,0,0,0
20200312,OH,5,30,0,0,35,9,1,10,0.1
20200312,OK,3,36,0,0,39,21,1,22,0.045454545
20200312,OR,19,286,0,0,305,0,0,0,0
20200312,PA,22,116,0,0,138,28,6,34,0.176470588
20200312,RI,5,94,0,0,99,0,0,0,0
20200312,SC,10,48,0,0,58,16,1,17,0.058823529
20200312,SD,8,27,0,0,35,14,3,17,0.176470588
20200312,TN,18,79,0,0,97,29,11,40,0.275
20200312,TX,23,0,0,0,23,0,2,2,1
20200312,UT,4,131,0,0,135,131,2,133,0.015037594
20200312,VA,17,117,0,0,134,57,8,65,0.123076923
20200312,VT,2,136,0,0,138,45,0,45,0
20200312,WA,799,10563,44,0,11362,3587,178,3765,0.047277556
20200312,WI,8,84,0,0,92,41,5,46,0.108695652
20200312,WV,0,7,0,0,7,4,0,4,0
20200312,WY,1,0,0,0,1,0,1,1,1
20200311,AK,0,46,0,0,46,23,0,23,0
20200311,AL,0,10,0,0,10,10,0,10,0
20200311,AR,0,12,0,0,12,0,0,0,0
20200311,AZ,9,59,0,0,68,8,3,11,0.272727273
20200311,CA,157,916,0,0,1073,226,24,250,0.096
20200311,CO,28,251,0,0,279,109,16,125,0.128
20200311,CT,3,71,0,0,74,17,1,18,0.055555556
20200311,DC,5,20,0,0,25,3,0,3,0
20200311,DE,1,17,0,0,18,0,1,1,1
20200311,FL,28,301,2,0,329,79,9,88,0.102272727
20200311,GA,22,0,0,0,22,0,5,5,1
20200311,HI,2,0,0,0,2,0,0,0,0
20200311,IA,13,46,0,0,59,14,5,19,0.263157895
20200311,ID,0,67,0,0,67,26,0,26,0
20200311,IL,19,244,0,0,263,0,0,0,0
20200311,IN,10,33,0,0,43,3,4,7,0.571428571
20200311,KS,1,41,0,0,42,24,0,24,0
20200311,KY,8,46,0,0,54,18,2,20,0.1
20200311,LA,6,37,0,0,43,26,5,31,0.161290323
20200311,MD,9,94,0,0,103,5,3,8,0.375
20200311,ME,0,42,0,0,42,22,0,22,0
20200311,MI,497,57,0,0,554,18,139,157,0.885350318
20200311,MN,5,217,0,0,222,85,2,87,0.022988506
20200311,MO,1,0,0,0,1,0,0,0,0
20200311,MS,0,20,0,0,20,20,0,20,0
20200311,MT,0,21,0,0,21,6,0,6,0
20200311,NC,7,0,0,0,7,0,0,0,0
20200311,ND,0,7,0,0,7,1,0,1,0
20200311,NE,5,47,0,0,52,0,2,2,1
20200311,NH,4,38,0,0,42,0,0,0,0
20200311,NJ,24,57,1,0,81,13,9,22,0.409090909
20200311,NM,3,87,0,0,90,18,3,21,0.142857143
20200311,NV,5,168,0,0,173,154,4,158,0.025316456
20200311,NY,216,92,0,0,308,0,43,43,1
20200311,OH,4,21,0,0,25,7,1,8,0.125
20200311,OK,2,15,0,0,17,0,0,0,0
20200311,OR,19,286,0,0,305,73,4,77,0.051948052
20200311,PA,16,88,0,0,104,88,4,92,0.043478261
20200311,RI,5,94,0,0,99,36,2,38,0.052631579
20200311,SC,9,32,0,0,41,8,2,10,0.2
20200311,SD,5,13,0,0,18,2,5,7,0.714285714
20200311,TN,7,50,0,0,57,50,0,50,0
20200311,TX,21,0,0,0,21,0,8,8,1
20200311,UT,2,0,0,0,2,0,0,0,0
20200311,VA,9,60,0,0,69,7,1,8,0.125
20200311,VT,2,91,0,0,93,31,1,32,0.03125
20200311,WA,621,6976,40,0,7597,2128,133,2261,0.058823529
20200311,WI,3,43,0,0,46,7,1,8,0.125
20200311,WV,0,3,0,0,3,1,0,1,0
20200311,WY,0,0,0,0,0,0,0,0,0
20200310,AK,0,23,0,0,23,0,0,0,0
20200310,AL,0,0,0,0,0,0,0,0,0
20200310,AR,0,12,0,0,12,0,0,0,0
20200310,AZ,6,51,0,0,57,7,1,8,0.125
20200310,CA,133,690,0,0,823,0,19,19,1
20200310,CO,12,142,0,0,154,9,3,12,0.25
20200310,CT,2,54,0,0,56,8,1,9,0.111111111
20200310,DC,5,17,0,0,22,3,4,7,0.571428571
20200310,DE,0,17,0,0,17,2,0,2,0
20200310,FL,19,222,0,0,241,82,1,83,0.012048193
20200310,GA,17,0,0,0,17,0,5,5,1
20200310,HI,2,0,0,0,2,0,0,0,0
20200310,IA,8,32,0,0,40,6,5,11,0.454545455
20200310,ID,0,41,0,0,41,0,0,0,0
20200310,IL,19,244,0,0,263,53,12,65,0.184615385
20200310,IN,6,30,0,0,36,30,4,34,0.117647059
20200310,KS,1,17,0,0,18,6,0,6,0
20200310,KY,6,28,0,0,34,11,2,13,0.153846154
20200310,LA,1,11,0,0,12,6,0,6,0
20200310,MD,6,89,0,0,95,16,1,17,0.058823529
20200310,ME,0,20,0,0,20,19,0,19,0
20200310,MI,358,39,0,0,397,3,104,107,0.971962617
20200310,MN,3,132,0,0,135,52,1,53,0.018867925
20200310,MO,1,0,0,0,1,0,0,0,0
20200310,MS,0,0,0,0,0,0,0,0,0
20200310,MT,0,15,0,0,15,4,0,4,0
20200310,NC,7,0,0,0,7,0,5,5,1
20200310,ND,0,6,0,0,6,6,0,6,0
20200310,NE,3,47,0,0,50,11,0,11,0
20200310,NH,4,38,0,0,42,0,0,0,0
20200310,NJ,15,44,0,0,59,9,4,13,0.307692308
20200310,NM,0,69,0,0,69,12,0,12,0
20200310,NV,1,14,0,0,15,0,0,0,0
20200310,NY,173,92,0,0,265,0,31,31,1
20200310,OH,3,14,0,0,17,3,0,3,0
20200310,OK,2,15,0,0,17,7,1,8,0.125
20200310,OR,15,213,0,0,228,48,1,49,0.020408163
20200310,PA,12,0,0,0,12,0,2,2,1
20200310,RI,3,58,0,0,61,28,0,28,0
20200310,SC,7,24,0,0,31,0,0,0,0
20200310,SD,0,11,0,0,11,6,0,6,0
20200310,TN,7,0,0,0,7,0,4,4,1
20200310,TX,13,0,0,0,13,0,1,1,1
20200310,UT,2,0,0,0,2,0,1,1,1
20200310,VA,8,53,0,0,61,15,5,20,0.25
20200310,VT,1,60,0,0,61,24,0,24,0
20200310,WA,488,4848,37,0,5336,1675,110,1785,0.06162465
20200310,WI,2,36,0,0,38,0,1,1,1
20200310,WV,0,2,0,0,2,0,0,0,0
20200310,WY,0,0,0,0,0,0,0,0,0
20200309,AK,0,23,0,0,23,9,0,9,0
20200309,AL,0,0,0,0,0,0,0,0,0
20200309,AR,0,12,0,0,12,6,0,6,0
20200309,AZ,5,44,0,0,49,0,0,0,0
20200309,CA,114,690,0,0,804,228,26,254,0.102362205
20200309,CO,9,133,0,0,142,29,1,30,0.033333333
20200309,CT,1,46,0,0,47,17,0,17,0
20200309,DC,1,14,0,0,15,4,0,4,0
20200309,DE,0,15,0,0,15,5,0,5,0
20200309,FL,18,140,0,0,158,22,1,23,0.043478261
20200309,GA,12,0,0,0,12,0,5,5,1
20200309,HI,2,0,0,0,2,0,1,1,1
20200309,IA,3,26,0,0,29,11,3,14,0.214285714
20200309,ID,0,41,0,0,41,14,0,14,0
20200309,IL,7,191,0,0,198,0,1,1,1
20200309,IN,2,0,0,0,2,0,0,0,0
20200309,KS,1,11,0,0,12,0,0,0,0
20200309,KY,4,17,0,0,21,4,3,7,0.428571429
20200309,LA,1,5,0,0,6,0,1,1,1
20200309,MD,5,73,0,0,78,21,2,23,0.086956522
20200309,ME,0,1,0,0,1,0,0,0,0
20200309,MI,254,36,0,0,290,10,86,96,0.895833333
20200309,MN,2,80,0,0,82,32,1,33,0.03030303
20200309,MO,1,0,0,0,1,0,0,0,0
20200309,MS,0,0,0,0,0,0,0,0,0
20200309,MT,0,11,0,0,11,0,0,0,0
20200309,NC,2,0,0,0,2,0,0,0,0
20200309,ND,0,0,0,0,0,0,0,0,0
20200309,NE,3,36,0,0,39,19,2,21,0.095238095
20200309,NH,4,38,0,0,42,0,0,0,0
20200309,NJ,11,35,0,0,46,4,5,9,0.555555556
20200309,NM,0,57,0,0,57,9,0,9,0
20200309,NV,1,14,0,0,15,0,0,0,0
20200309,NY,142,92,0,0,234,0,37,37,1
20200309,OH,3,11,0,0,14,1,3,4,0.75
20200309,OK,1,8,0,0,9,0,0,0,0
20200309,OR,14,165,0,0,179,65,0,65,0
20200309,PA,10,0,0,0,10,0,4,4,1
20200309,RI,3,30,0,0,33,0,0,0,0
20200309,SC,7,24,0,0,31,16,5,21,0.238095238
20200309,SD,0,5,0,0,5,0,0,0,0
20200309,TN,3,0,0,0,3,0,0,0,0
20200309,TX,12,0,0,0,12,0,4,4,1
20200309,UT,1,0,0,0,1,0,0,0,0
20200309,VA,3,38,0,0,41,2,1,3,0.333333333
20200309,VT,1,36,0,0,37,6,0,6,0
20200309,WA,378,3173,35,0,3551,965,61,1026,0.059454191
20200309,WI,1,36,0,0,37,5,0,5,0
20200309,WV,0,2,0,0,2,0,0,0,0
20200309,WY,0,0,0,0,0,0,0,0,0
20200308,AK,0,14,0,0,14,2,0,2,0
20200308,AL,0,0,0,0,0,0,0,0,0
20200308,AR,0,6,0,0,6,0,0,0,0
20200308,AZ,5,44,0,0,49,0,0,0,0
20200308,CA,88,462,0,0,550,0,19,19,1
20200308,CO,8,104,0,0,112,49,0,49,0
20200308,CT,1,29,0,0,30,29,1,30,0.033333333
20200308,DC,1,10,0,0,11,2,1,3,0.333333333
20200308,DE,0,10,0,0,10,0,0,0,0
20200308,FL,17,118,0,0,135,18,3,21,0.142857143
20200308,GA,7,0,0,0,7,0,1,1,1
20200308,HI,1,0,0,0,1,0,0,0,0
20200308,IA,0,15,0,0,15,0,0,0,0
20200308,ID,0,27,0,0,27,0,0,0,0
20200308,IL,6,191,0,0,197,0,0,0,0
20200308,IN,2,0,0,0,2,0,1,1,1
20200308,KS,1,11,0,0,12,0,1,1,1
20200308,KY,1,13,0,0,14,4,0,4,0
20200308,LA,0,5,0,0,5,5,0,5,0
20200308,MD,3,52,0,0,55,11,0,11,0
20200308,ME,0,1,0,0,1,0,0,0,0
20200308,MI,168,26,0,0,194,8,40,48,0.833333333
20200308,MN,1,48,0,0,49,0,0,0,0
20200308,MO,1,0,0,0,1,0,1,1,1
20200308,MS,0,0,0,0,0,0,0,0,0
20200308,MT,0,11,0,0,11,0,0,0,0
20200308,NC,2,0,0,0,2,0,0,0,0
20200308,ND,0,0,0,0,0,0,0,0,0
20200308,NE,1,17,0,0,18,0,0,0,0
20200308,NH,4,38,0,0,42,18,2,20,0.1
20200308,NJ,6,31,0,0,37,31,2,33,0.060606061
20200308,NM,0,48,0,0,48,0,0,0,0
20200308,NV,1,14,0,0,15,0,0,0,0
20200308,NY,105,92,0,0,197,0,29,29,1
20200308,OH,0,10,0,0,10,1,0,1,0
20200308,OK,1,8,0,0,9,8,0,8,0
20200308,OR,14,100,0,0,114,23,7,30,0.233333333
20200308,PA,6,0,0,0,6,0,2,2,1
20200308,RI,3,30,0,0,33,0,1,1,1
20200308,SC,2,8,0,0,10,0,0,0,0
20200308,SD,0,5,0,0,5,0,0,0,0
20200308,TN,3,0,0,0,3,0,2,2,1
20200308,TX,8,0,0,0,8,0,0,0,0
20200308,UT,1,0,0,0,1,0,0,0,0
20200308,VA,2,36,0,0,38,5,2,7,0.285714286
20200308,VT,1,30,0,0,31,5,0,5,0
20200308,WA,317,2208,31,0,2525,462,61,523,0.116634799
20200308,WI,1,31,0,0,32,0,0,0,0
20200308,WV,0,2,0,0,2,0,0,0,0
20200308,WY,0,0,0,0,0,0,0,0,0
20200307,AK,0,12,0,0,12,4,0,4,0
20200307,AL,0,0,0,0,0,0,0,0,0
20200307,AR,0,6,0,0,6,0,0,0,0
20200307,AZ,5,44,0,0,49,11,2,13,0.153846154
20200307,CA,69,462,0,0,531,0,9,9,1
20200307,CO,8,55,0,0,63,9,6,15,0.4
20200307,CT,0,0,0,0,0,0,0,0,0
20200307,DC,0,8,0,0,8,0,0,0,0
20200307,DE,0,10,0,0,10,0,0,0,0
20200307,FL,14,100,0,0,114,45,5,50,0.1
20200307,GA,6,0,0,0,6,0,4,4,1
20200307,HI,1,0,0,0,1,0,0,0,0
20200307,IA,0,15,0,0,15,0,0,0,0
20200307,ID,0,27,0,0,27,0,0,0,0
20200307,IL,6,191,0,0,197,11,1,12,0.083333333
20200307,IN,1,0,0,0,1,0,0,0,0
20200307,KS,0,11,0,0,11,7,0,7,0
20200307,KY,1,9,0,0,10,2,1,3,0.333333333
20200307,LA,0,0,0,0,0,0,0,0,0
20200307,MD,3,41,0,0,44,15,0,15,0
20200307,ME,0,1,0,0,1,0,0,0,0
20200307,MI,128,18,0,0,146,10,30,40,0.75
20200307,MN,1,48,0,0,49,12,1,13,0.076923077
20200307,MO,0,0,0,0,0,0,0,0,0
20200307,MS,0,0,0,0,0,0,0,0,0
20200307,MT,0,11,0,0,11,0,0,0,0
20200307,NC,2,0,0,0,2,0,0,0,0
20200307,ND,0,0,0,0,0,0,0,0,0
20200307,NE,1,17,0,0,18,0,1,1,1
20200307,NH,2,20,0,0,22,0,0,0,0
20200307,NJ,4,0,0,0,4,0,3,3,1
20200307,NM,0,48,0,0,48,32,0,32,0
20200307,NV,1,14,0,0,15,0,0,0,0
20200307,NY,76,92,0,0,168,0,43,43,1
20200307,OH,0,9,0,0,9,1,0,1,0
20200307,OK,1,0,0,0,1,0,0,0,0
20200307,OR,7,77,0,0,84,13,4,17,0.235294118
20200307,PA,4,0,0,0,4,0,2,2,1
20200307,RI,2,30,0,0,32,13,-1,12,-0.083333333
20200307,SC,2,8,0,0,10,3,2,5,0.4
20200307,SD,0,5,0,0,5,0,0,0,0
20200307,TN,1,0,0,0,1,0,0,0,0
20200307,TX,8,0,0,0,8,0,3,3,1
20200307,UT,1,0,0,0,1,0,0,0,0
20200307,VA,0,31,0,0,31,10,0,10,0
20200307,VT,1,25,0,0,26,25,1,26,0.038461538
20200307,WA,256,1746,27,0,2002,367,38,405,0.09382716
20200307,WI,1,31,0,0,32,0,0,0,0
20200307,WV,0,2,0,0,2,1,0,1,0
20200307,WY,0,0,0,0,0,0,0,0,0
20200306,AK,0,8,0,0,8,0,0,0,0
20200306,AR,0,6,0,0,6,0,0,0,0
20200306,AZ,3,33,0,0,36,5,1,6,0.166666667
20200306,CA,60,462,0,0,522,0,7,7,1
20200306,CO,2,46,0,0,48,27,2,29,0.068965517
20200306,DC,0,8,0,0,8,2,0,2,0
20200306,DE,0,10,0,0,10,0,0,0,0
20200306,FL,9,55,0,0,64,24,0,24,0
20200306,GA,2,0,0,0,2,0,0,0,0
20200306,IA,0,15,0,0,15,0,0,0,0
20200306,IL,5,180,0,0,185,15,0,15,0
20200306,IN,1,0,0,0,1,0,0,0,0
20200306,KS,0,4,0,0,4,0,0,0,0
20200306,KY,0,7,0,0,7,0,0,0,0
20200306,MD,3,26,0,0,29,9,3,12,0.25
20200306,MI,98,8,0,0,106,0,26,26,1
20200306,MN,0,36,0,0,36,0,0,0,0
20200306,NC,2,0,0,0,2,0,1,1,1
20200306,NE,0,17,0,0,17,0,0,0,0
20200306,NH,2,20,0,0,22,4,0,4,0
20200306,NJ,1,0,0,0,1,0,0,0,0
20200306,NM,0,16,0,0,16,0,0,0,0
20200306,NV,1,14,0,0,15,0,0,0,0
20200306,NY,33,92,0,0,125,16,11,27,0.407407407
20200306,OH,0,8,0,0,8,1,0,1,0
20200306,OR,3,64,0,0,67,19,0,19,0
20200306,PA,2,0,0,0,2,0,0,0,0
20200306,RI,3,17,0,0,20,0,1,1,1
20200306,SC,0,5,0,0,5,0,0,0,0
20200306,TN,1,0,0,0,1,0,0,0,0
20200306,TX,5,0,0,0,5,0,4,4,1
20200306,VA,0,21,0,0,21,3,0,3,0
20200306,VT,0,0,0,0,0,0,0,0,0
20200306,WA,218,1379,26,0,1597,435,39,474,0.082278481
20200306,WI,1,31,0,0,32,12,0,12,0
20200306,WV,0,1,0,0,1,0,0,0,0
20200305,AZ,2,28,0,0,30,1,0,1,0
20200305,CA,53,462,0,0,515,0,0,0,0
20200305,CO,0,19,0,0,19,0,0,0,0
20200305,DC,0,6,0,0,6,0,0,0,0
20200305,FL,9,31,0,0,40,7,7,14,0.5
20200305,GA,2,0,0,0,2,0,0,0,0
20200305,IL,5,165,0,0,170,41,1,42,0.023809524
20200305,MD,0,17,0,0,17,0,0,0,0
20200305,MI,72,8,0,0,80,8,20,28,0.714285714
20200305,NC,1,0,0,0,1,0,0,0,0
20200305,NE,0,17,0,0,17,0,0,0,0
20200305,NH,2,16,0,0,18,6,0,6,0
20200305,NJ,1,0,0,0,1,0,0,0,0
20200305,NV,1,14,0,0,15,0,0,0,0
20200305,NY,22,76,0,0,98,28,16,44,0.363636364
20200305,OH,0,7,0,0,7,0,0,0,0
20200305,OR,3,45,0,0,48,16,0,16,0
20200305,RI,2,17,0,0,19,6,0,6,0
20200305,SC,0,5,0,0,5,0,0,0,0
20200305,TN,1,0,0,0,1,0,0,0,0
20200305,TX,1,0,0,0,1,0,0,0,0
20200305,VA,0,18,0,0,18,0,0,0,0
20200305,WA,179,944,20,0,1123,311,51,362,0.140883978
20200305,WI,1,19,0,0,20,0,0,0,0
20200304,AZ,2,27,0,0,29,0,0,0,0
20200304,CA,53,462,0,0,515,0,0,0,0
20200304,FL,2,24,0,0,26,0,0,0,0
20200304,GA,2,0,0,0,2,0,0,0,0
20200304,IL,4,124,0,0,128,0,0,0,0
20200304,MI,52,0,0,0,52,0,18,18,1
20200304,NC,1,0,0,0,1,0,0,0,0
20200304,NH,2,10,0,0,12,0,0,0,0
20200304,NY,6,48,0,0,54,0,0,0,0
20200304,OR,3,29,0,0,32,0,0,0,0
20200304,RI,2,11,0,0,13,5,0,5,0
20200304,SC,0,5,0,0,5,0,0,0,0
20200304,TX,1,0,0,0,1,0,0,0,0
20200304,WA,128,633,16,0,761,206,38,244,0.155737705
20200304,WI,1,19,0,0,20,0,0,0,0
20200303,MI,34,0,0,0,34,0,16,16,1
20200303,RI,2,6,0,0,8,6,1,7,0.142857143
20200303,WA,90,427,14,0,517,198,25,223,0.112107623
20200302,MI,18,0,0,0,18,0,9,9,1
20200302,RI,1,0,0,0,1,0,0,0,0
20200302,WA,65,229,11,0,294,148,31,179,0.173184358
20200301,MI,9,0,0,0,9,0,0,0,0
20200301,RI,1,0,0,0,1,0,0,0,0
20200301,WA,34,81,8,0,115,58,16,74,0.216216216
20200229,WA,18,23,5,0,41,23,9,32,0.28125
20200228,WA,9,0,4,0,9,0,7,7,1
20200227,WA,2,0,2,0,2,0,0,0,0
20200226,WA,2,0,2,0,2,0,0,0,0
20200225,WA,2,0,0,0,2,0,0,0,0
20200224,WA,2,0,0,0,2,0,0,0,0
20200223,WA,2,0,0,0,2,0,0,0,0
20200222,WA,2,0,0,0,2,0,0,0,0
20200221,WA,2,0,0,0,2,0,0,0,0
20200220,WA,2,0,0,0,2,0,0,0,0
20200219,WA,2,0,0,0,2,0,0,0,0
20200218,WA,2,0,0,0,2,0,0,0,0
20200217,WA,2,0,0,0,2,0,0,0,0
20200216,WA,2,0,0,0,2,0,0,0,0
20200215,WA,2,0,0,0,2,0,0,0,0
20200214,WA,2,0,0,0,2,0,0,0,0
20200213,WA,2,0,0,0,2,0,0,0,0
20200212,WA,2,0,0,0,2,0,0,0,0
20200211,WA,2,0,0,0,2,0,0,0,0
20200210,WA,2,0,0,0,2,0,0,0,0
20200209,WA,2,0,0,0,2,0,0,0,0
20200208,WA,2,0,0,0,2,0,0,0,0
20200207,WA,2,0,0,0,2,0,1,1,1
20200206,WA,1,0,0,0,1,0,0,0,0
20200205,WA,1,0,0,0,1,0,0,0,0
20200204,WA,1,0,0,0,1,0,0,0,0
20200203,WA,1,0,0,0,1,0,0,0,0
20200202,WA,1,0,0,0,1,0,0,0,0
20200201,WA,1,0,0,0,1,0,0,0,0
20200131,WA,1,0,0,0,1,0,0,0,0
20200130,WA,1,0,0,0,1,0,0,0,0
20200129,WA,1,0,0,0,1,0,0,0,0
20200128,WA,1,0,0,0,1,0,0,0,0
20200127,WA,1,0,0,0,1,0,0,0,0
20200126,WA,1,0,0,0,1,0,0,0,0
20200125,WA,1,0,0,0,1,0,0,0,0
20200124,WA,1,0,0,0,1,0,0,0,0
20200123,WA,1,0,0,0,1,0,0,0,0
20200122,WA,1,0,0,0,1,0,0,0,0
